>s
Front Of The Cottage
You stand in front of a large two storey cottage. Cornfields are to the North. A path leads around the side of the cottage to the southwest. You feel unseen eyes watching you.

>sw
You follow garden path to the back of the cottage.

Back of the Cottage
You are standing behind the cottage.

There is an old plough here.

>nw
You can't go that way.

>ne
You follow the garden path around to the front of the cottage.

OMG the scarecrow dissapeared!

North Of The Cottage
You stand in front of a large two storey cottage. Cornfields are to the North. A path leads around the side of the cottage to the southwest.

>n
The Cornfields
You are standing in a field of corn. To the north is a wooden gate leading to a farm path. A cottage lies to the south.

>examine post
An old wooden post.

You feel a cool breeze.

* * *

>sw
You follow garden path to the back of the cottage.

Back of the Cottage
You are standing behind the cottage.

There is an old plough here.

>ne
AAAAARGH!

North Of The Cottage
You stand in front of a large two storey cottage. Cornfields are to the North. A path leads around the side of the cottage to the southwest.   

You hear a crow above.

>n
The Cornfields
You are standing in a field of corn. To the north is a wooden gate leading to a farm path. A cottage lies to the south.

An old rotting wooden post is here. Popped up against the post is a hideous scarecrow.

>get note
Taken.

>read note
The author has used aggressive straight lines to etch out each letter. The message on the note reads:  "Your place is in the fields"

>s
North Of The Cottage
You stand in front of a large two storey cottage. Cornfields are to the North. A path leads around the side of the cottage to the southwest.

>n
The Cornfields
You are standing in a field of corn. To the north is a wooden gate leading to a farm path. A cottage lies to the south.

An old rotting wooden post is here. 

You hear a crow above.

* * *

>n
The Cornfields
You are standing in a field of corn. To the north is a wooden gate leading to a farm path. A cottage lies to the south.

An old rotting wooden post is here. Popped up against the post is a hideous scarecrow.

>x post
The old wooden post is a brownish green colour and is damp to the touch.

On the post is a note.

You feel a cool breeze.

>x sky
Dull, grey clouds hang overhead.

* * *

>n
The Cornfields
You are standing in a field of corn. To the north is a wooden gate leading to a farm path. A cottage lies to the south.

An old rotting wooden post is here. Popped up against the post is a hideous scarecrow.

>read note
There is a message inscribed onto the note in what looks like charcoal. The author has used aggressive straight lines to etch out each letter. The message reads:

 "Your place is in the fields"

>s
North Of The Cottage
You stand in front of a large two storey cottage. Cornfields are to the North. A path leads around the side of the cottage to the southwest.  You see a strange figure at the window  

You can see something pinned to the post where the scarecrow used to be.

You feel a cool breeze.

>n
The Cornfields
You are standing in a field of corn. To the north is a wooden gate leading to a farm path. A cottage lies to the south.

An old rotting wooden post is here. 

On the post is a note.

>s
North Of The Cottage
You stand in front of a large two storey cottage. Cornfields are to the North. A path leads around the side of the cottage to the southwest.  You see a strange figure at the window

>examine figure
You see nothing special about the strange figure.

As your eyes begin to focus more clearly, the strange figure fades from view. Was it even there in the first place?

>n
The Cornfields
You are standing in a field of corn. To the north is a wooden gate leading to a farm path. A cottage lies to the south.

An old rotting wooden post is here. 

On the post is a note.

>s
North Of The Cottage
You stand in front of a large two storey cottage. Cornfields are to the North. A path leads around the side of the cottage to the southwest.

* * *

>s
North Of The Cottage
You stand in front of a large two storey cottage. Cornfields are to the North. A path leads around the side of the cottage to the southwest.  You see a strange figure at the window  

You can see something pinned to the post where the scarecrow used to be.

You feel a cool breeze.

>examine figure
Is that a person?

As your eyes begin to focus more clearly, the strange figure fades from view. Was it even there in the first place?

* * *

>n
The Cornfields
You are standing in a field of corn. To the north is a wooden gate leading to a farm path. A cottage lies to the south.

An old rotting wooden post is here. Popped up against the post is a hideous scarecrow.

>examine note
There is a message inscribed onto the note in what looks like charcoal. The author has used aggressive straight lines to etch out each letter. The message reads:

 "Your place is in the fields"

>s
North Of The Cottage
You stand in front of a large two storey cottage. Cornfields are to the North. A path leads around the side of the cottage to the southwest. 

You can see a strange figure here.

You feel a cool breeze.

* * *

>n
The Cornfields
You are standing in a field of corn. To the north is a wooden gate leading to a farm path. A cottage lies to the south.

An old rotting wooden post is here. Popped up against the post is a hideous scarecrow.

>read not
You can't see any such thing.

>read note
There is a message inscribed onto the note in what looks like charcoal. The author has used aggressive straight lines to etch out each letter. The message reads:

 "Your place is in the fields"

>s
North Of The Cottage
You stand in front of a large two storey cottage. Cornfields are to the North. A path leads around the side of the cottage to the southwest.  You see a strange figure at the window  

To the north you can see something pinned to the post where the scarecrow used to be.

>get figure
That's hardly portable.

>examine figure
You see a strange figure at the window.

As your eyes begin to focus more clearly, the figure fades from view. Was it even there in the first place?

You feel a cool breeze.

>examine surroundings
You can't see any such thing.

>look
North Of The Cottage
You stand in front of a large two storey cottage. Cornfields are to the North. A path leads around the side of the cottage to the southwest.    

To the north you can see something pinned to the post where the scarecrow used to be.

You feel a cool breeze.

>look around
You can't see any such thing.

>x
What do you want to examine?

>sw
You see nothing unexpected in that direction.

You feel a cool breeze.

>s
(first opening the Front Door)
You heave with all of your might but the heavy oak door will not budge.

It seems to be locked.

>sw
You follow garden path to the back of the cottage.

South of the Cottage
You are standing behind the cottage.

There is an old plough here.

>x plough
It is an old plough.

resting on the plough, you see a rusty key.

>s
You can't go that way.

>x
(the plough)
It is an old plough.

On the plough is a rusty key.

>get key
Taken.

>n
You can't go that way.

>nw
You can't go that way.

>ne
You follow the garden path around to the front of the cottage.

North Of The Cottage
You stand in front of a large two storey cottage. Cornfields are to the North. A path leads around the side of the cottage to the southwest.    

To the north you can see something pinned to the post where the scarecrow used to be.

>unlock door
(with the rusty key)
You unlock the Front Door.

>enter cottage
(first opening the Front Door)

The Lobby
You are in the lobby.

>quit
Are you sure you want to quit?

>y
[ The game has finished ]

* * *

>n
The Cornfields
You are standing in a field of corn. To the north is a wooden gate leading to a farm path. A cottage lies to the south.

An old rotting wooden post is here. Popped up against the post is a hideous scarecrow.

>s
North Of The Cottage
You stand in front of a large two storey cottage. Cornfields are to the North. A path leads around the side of the cottage to the southwest.   

You feel a cool breeze.

>sw
You follow garden path to the back of the cottage.

South of the Cottage
You are standing behind the cottage.

There is an old plough here.

>examine plough
It is an old plough.

resting on the plough, you see a rusty key.
OMG the scarecrow dissapeared!

* * *

>ne
AAAAARGH!

North Of The Cottage
You stand in front of a large two storey cottage. Cornfields are to the North. A path leads around the side of the cottage to the southwest.   

You hear a crow above.

>sw
You follow garden path to the back of the cottage.

South of the Cottage
You are standing behind the cottage.

There is an old plough here.

>nw
You follow the garden path around to the front of the cottage.

North Of The Cottage
You stand in front of a large two storey cottage. Cornfields are to the North. A path leads around the side of the cottage to the southwest.

>s
(first opening the Front Door)
You heave with all of your might but the heavy oak door will not budge.

It seems to be locked.

* * *

>x plough
It is an old plough.

resting on the plough, you see a rusty key.

>get ke
You can't see any such thing.

>get key
Taken.

>nw
You follow the garden path around to the front of the cottage.

North Of The Cottage
You stand in front of a large two storey cottage. Cornfields are to the North. A path leads around the side of the cottage to the southwest.   

You feel a cool breeze.

>s
(first opening the Front Door)
You heave with all of your might but the heavy oak door will not budge.

It seems to be locked.

>unlock door with key
You unlock the Front Door.

>s
(first opening the Front Door)

The Lobby
You are in the lobby. The air here is musty.

* * *

>sw
You follow garden path to the back of the cottage.

Back of the Cottage
You are standing behind the cottage.

There is an old plough here.

>x plough
It is an old plough.

resting on the plough, you see a rusty key.

>get key
As you pick up the key, you hear four loud bangs coming from the front of the cottage.

>ne
You follow the garden path around to the front of the cottage.

North Of The Cottage
You stand in front of a large two storey cottage. Cornfields are to the North. A path leads around the side of the cottage to the southwest.    

To the north you can see something nailed to the post where the scarecrow used to rest.

>unlock door
(with the rusty key)
You unlock the Front Door.

>s
(first opening the Front Door)

The Lobby
 As you enter the cottage, you feel nauseous and short of breath. Surfaces feel cold and damp to the touch.   You are in the lobby. The room is large and mostly empty, save for a few shelves.

You can see a shelf (on which is a clock) here.

* * *

>ne
You follow the garden path around to the front of the cottage.

North Of The Cottage
You stand in front of a large two storey cottage. Cornfields are to the North. A path leads around the side of the cottage to the southwest.    

To the north you can see something nailed to the post where the scarecrow used to rest.

>n
The Cornfields
You are standing in a field of corn. To the north is a wooden gate leading to a farm path. A cottage lies to the south.

An old rotting wooden post is here. 

On the post is a note.

You feel a cool breeze.

>x note
There is a message inscribed onto the note in what looks like charcoal. The author has used aggressive straight lines to etch out each letter. The message reads:

 "Your place is in the fields"

You feel a cool breeze.

* * *

>n
The Cornfields
You are standing in a field of corn. To the north is a wooden gate leading to a farm path. A cottage lies to the south.

An old rotting wooden post is here. 

On the post is a note.

You feel a cool breeze.

>s
North Of The Cottage
You stand in front of a large two storey cottage. Cornfields are to the North. A path leads around the side of the cottage to the southwest.    

To the north you can see something nailed to the post where the scarecrow used to be.

* * *

>x plough
It is an old plough.

resting on the plough, you see a rusty key.

>ne
You follow the garden path around to the front of the cottage.

North Of The Cottage
You stand in front of a large two storey cottage. Cornfields are to the North. A path leads around the side of the cottage to the southwest.    

To the north you can see something pinned to the post where the scarecrow used to be.

You feel a cool breeze.

* * *

>x plough
It is an old plough.

resting on the plough, you see a rusty key.

>nw
You follow the garden path around to the front of the cottage.

North Of The Cottage
You stand in front of a large two storey cottage. Cornfields are to the North. A path leads around the side of the cottage to the southwest.    

To the north you can see something nailed to the post where the scarecrow used to be.

You feel a cool breeze.

* * *

>s
Front Of The Cottage
You stand in front of a large two storey cottage. Cornfields are to the North. A path leads around the side of the cottage to the southwest. You feel unseen eyes watching you.

>s
(first opening the Front Door)
You heave with all of your might but the heavy oak door will not budge.

It seems to be locked.

You hear a crow above.

>n
The Cornfields
You are standing in a field of corn. To the north is a wooden gate leading to a farm path. A cottage lies to the south.

An old rotting wooden post is here. Popped up against the post is a hideous scarecrow.

I beg your pardon?

>n
The Farm Path
You are standing on a dusty and well-trodden farm path. To the south is a wooden gate, over which you can see a thatched-roof cottage. Fields of corn surround the cottage and form a patchwork vista of green and yellow draped over the distant hills. 

You feel a cool breeze.

>s
The Cornfields
You are standing in a field of corn. To the north is a wooden gate leading to a farm path. A cottage lies to the south.

An old rotting wooden post is here. Popped up against the post is a hideous scarecrow.

You hear a crow above.

* * *

I beg your pardon?

>look
North Of The Cottage
You stand in front of a large two storey cottage. Cornfields are to the North. A path leads around the side of the cottage to the southwest. You feel unseen eyes watching you.

>n
The Cornfields
You are standing in a field of corn. To the north is a wooden gate leading to a farm path. A cottage lies to the south.

An old rotting wooden post is here. Popped up against the post is a hideous scarecrow.

* * *

>s
(first opening the Front Door)
You heave with all of your might but the heavy oak door will not budge.

It seems to be locked.

You hear a crow above.

>sw
You follow garden path to the back of the cottage.

South of the Cottage
You are standing behind the cottage.

There is an old plough here.

>ne
You follow the garden path around to the front of the cottage.

OMG the scarecrow dissapeared!

AAAAARGH!

* * *

>sw
You follow garden path to the back of the cottage.

South of the Cottage
You are standing behind the cottage.

There is an old plough here.

>nw
North Of The Cottage
You stand in front of a large two storey cottage. Cornfields are to the North. A path leads around the side of the cottage to the southwest.

>sw
You follow garden path to the back of the cottage.

South of the Cottage
You are standing behind the cottage.

There is an old plough here.

>nw
North Of The Cottage
You stand in front of a large two storey cottage. Cornfields are to the North. A path leads around the side of the cottage to the southwest.   

You feel a cool breeze.

>se
You follow garden path to the back of the cottage.

South of the Cottage
You are standing behind the cottage.

There is an old plough here.

>ne
You follow the garden path around to the front of the cottage.

North Of The Cottage
You stand in front of a large two storey cottage. Cornfields are to the North. A path leads around the side of the cottage to the southwest.   

You feel a cool breeze.

* * *

>x plough
It is an old plough.

resting on the plough, you see a rusty key.

>get key
Taken.

>ne
You follow the garden path around to the front of the cottage.

North Of The Cottage
You stand in front of a large two storey cottage. Cornfields are to the North. A path leads around the side of the cottage to the southwest.   

You hear a crow above.

>unlock door
(with the rusty key)
You unlock the Front Door.

You hear a crow above.

>s
(first opening the Front Door)

The Lobby
You are in the lobby. The air here is musty.

On the shelf is a clock.

>get clock
The clock is just fine where it is!

>x clock
The time reads ten past three.

* * *

>s
Front Of The Cottage
You stand in front of a large two storey cottage. Cornfields are to the North. A path leads around the side of the cottage to the southwest. You feel unseen eyes watching you.

>n
The Cornfields
You are standing in a field of corn. To the north is a wooden gate leading to a farm path. A cottage lies to the south.

An old rotting wooden post is here. Popped up against the post is a hideous scarecrow.

* * *

>s
North Of The Cottage
You stand in front of a large two storey cottage. Cornfields are to the North. A path leads around the side of the cottage to the southwest.   

You feel a cool breeze.

>s
(first opening the Front Door)
You heave with all of your might but the heavy oak door will not budge.

It seems to be locked.

* * *

>x plough
It is an old plough.

resting on the plough, you see a rusty key.

>get key
 You hear four loud bangs, around a second apart, coming from the front of the cottage.

* * *

>s
Front Of The Cottage
You stand in front of a large two storey cottage. Cornfields are to the North. A path leads around the side of the cottage to the southwest. You feel unseen eyes watching you.

>se
You follow garden path to the back of the cottage.

South of the Cottage
You are standing behind the cottage.

There is an old plough here.

>ne
You follow the garden path around to the front of the cottage.

You can't go that way.

>nw
North Of The Cottage
You stand in front of a large two storey cottage. Cornfields are to the North. A path leads around the side of the cottage to the southwest.   

You hear a crow above.

* * *

>se
You follow garden path to the back of the cottage.

South of the Cottage
You are standing behind the cottage.

There is an old plough here.

>sw
You can't go that way.

>nw
North Of The Cottage
You stand in front of a large two storey cottage. Cornfields are to the North. A path leads around the side of the cottage to the southwest.

>ne
You can't go that way.

You feel a cool breeze.

>sw
You follow garden path to the back of the cottage.

South of the Cottage
You are standing behind the cottage.

There is an old plough here.

>nw
North Of The Cottage
You stand in front of a large two storey cottage. Cornfields are to the North. A path leads around the side of the cottage to the southwest.   

You hear a crow above.

>se
You follow garden path to the back of the cottage.

South of the Cottage
You are standing behind the cottage.

There is an old plough here.

>ne
You follow the garden path around to the front of the cottage.

North Of The Cottage
You stand in front of a large two storey cottage. Cornfields are to the North. A path leads around the side of the cottage to the southwest.   

You hear a crow above.

>sw
You follow garden path to the back of the cottage.

South of the Cottage
You are standing behind the cottage.

There is an old plough here.

* * *

>examine post
An old wooden post  which supports a hideous scarecrow.

>s
North Of The Cottage
You stand in front of a large two storey cottage. Cornfields are to the North. A path leads around the side of the cottage to the southwest. You feel unseen eyes watching you.

>sw
You follow garden path to the back of the cottage.

South of the Cottage
You are standing behind the cottage.

There is an old plough here.

>ne
You follow the garden path around to the front of the cottage.

OMG the scarecrow dissapeared!

North Of The Cottage
You stand in front of a large two storey cottage. Cornfields are to the North. A path leads around the side of the cottage to the southwest.

* * *

>n
The Cornfields
You are standing in a field of corn. To the north is a wooden gate leading to a farm path. A cottage lies to the south.

>examine post
An old wooden post

* * *

>wait until 3:15
I only understood you as far as wanting to wait.

>wait 15 minutes
I only understood you as far as wanting to wait.

>wait
Time passes.

>n
The Farm Path
You are standing on a dusty and well-trodden farm path. To the south is a wooden gate, over which you can see a thatched-roof cottage. Fields of corn surround the cottage and form a patchwork vista of green and yellow draped over the distant hills.

>s
The Cornfields
You are standing in a field of corn. To the north is a wooden gate leading to a farm path. A cottage lies to the south.

An old rotting wooden post is here. Popped up against the post is a hideous scarecrow.

You hear a crow above.

>sw
The fields of corn stretch out as far as the eye can see. The only exit is the path to the North.

You feel a cool breeze.

* * *

The Scarecrow
An exploration of war and belonging by Mikey Hogarth The story genre is "Horror"
Release 1 / Serial number 130918 / Inform 7 build 6G60 (I6/v6.32 lib 6/12N) SD

The Farm Path
You are standing on a muddy farm path. A wooden gate to the south leads into a large barley field which forms part of a patchwork vista of yellow and brown draped over the distant landscape. The fields are separated by deep green foliage. 

Your journey here has been long and tiring. Beyond the field to the south you can see a thatched-roof cottage, a place you had once felt a connection with. A place you had once called home. In spite of your aching feet, the cottage no longer feels like an inviting respite. 

The weather is overcast and a gentle rain is falling.  

You see a small black cat sheltering under some nearby foliage.

>x
What do you want to examine?

>z
Time passes.

>z
Time passes.

The cat meows.

>l
The Farm Path
A wooden gate to the south leads to a field of barley. 

You see a small black cat sheltering under some nearby foliage.

>touch cat
As you approach the cat, it flees into the undergrowth.

>s
(first opening the wooden gate)

The Barley Field
As you enter the barley field, your mind drifts to the fields of battle in the aftermath of Waterloo. The casualties were horrendous, the victory far from glorious. Many of the soldiers who died that day, the "scum of the earth" as Wellington had described them, had been recruited from villages and hamlets nearby. Wellington had later claimed  that it was "really wonderful that we should have made these men into the fine fellows they are." You consider the barrenness of that sentiment now that tens of thousands of those fine fellows are dead. Many of those who survived were not the same people they once were, with some succumbing to war exhaustion and others to madness or worse.

And what of yourself? Are you a soldier or a farm-hand? Is a return to your old life a possibility or is something within your very soul broken beyond repair? What does a soldier do when there is nothing left to fight for? The chill wind is making it hard to breathe, and you begin to feel light headed. Further south through the fields you can see the old farm cottage. 

An old rotting wooden post is here. Propped up against the post, standing to attention, is a lone scarecrow.

You hear the harsh "caw" of a crow.

>s
Front Of The Cottage
You approach the front of a large two storey cottage. A field of barley lies to the North. A path leads around the side of the cottage to the southwest.    

The small black cat from the farm path is here, washing himself among the barley.

>touch cat
The cat seems more comfortable around you now.

The cat heads north to The Barley Field.

>n
The Barley Field
You are standing in a field of barley. To the north is a wooden gate leading to a farm path. A cottage lies to the south.

An old rotting wooden post is here. Propped up against the post, standing to attention, is a lone scarecrow.

You can also see a The cat here.

You feel a cool breeze.

The cat heads south to Front Of The Cottage.

* * *

Everything is supposed to be very quiet after a massacre, and it always is, except for the birds. And what do the birds say? All there is to say about a massacre, things like "Poo-tee-weet". -- Kurt Vonnegut

Please press SPACE to continue.

In the winter of 1815, after countless millions had perished, the Napoleonic Wars came to an end. The little corporal Napoleon Bonaparte, emperor of France for the decade previous, was exiled to the volcanic island of St Helena where he would see out the last six years of his life.

The end of the Napoleonic wars saw the start of a great agricultural depression in the United Kingdom that would last for a quarter of a century. Many farms succumbed to abandonment and disrepair as both landlords and tenants fell into bankruptcy.

It is in the wake of this ruin, far from the bloody fields of Waterloo and Rocquencourt, that you find yourself standing on a long farm road in Suffolk, surrounded by fields of oat, barley and wheat. A dull lifelessness hangs in the air like mist. All is silent, save for the cries of carrion crow circling above. You feel your heart longing for the rural paradise now lost to time and neglect.

Five hundred miles away, a young author called Mary Shelley has finished writing her first novel, "The Modern Prometheus"...

Please press SPACE to continue.

>s
(first opening the wooden gate)

The Cornfields
You are standing in a field of corn. To the north is a wooden gate leading to a farm path. A cottage lies to the south.

An old rotting wooden post is here. Popped up against the post is a hideous scarecrow.

You hear a crow above.

>s
North Of The Cottage
You stand in front of a large two storey cottage. Cornfields are to the North. A path leads around the side of the cottage to the southwest. You feel unseen eyes watching you.

>s
(first opening the Front Door)
You heave with all of your might but the heavy oak door will not budge.

It seems to be locked.

You hear a crow above.

* * *

>sw
You follow garden path to the back of the cottage.

South of the Cottage
You are standing behind the cottage.

There is an old plough here.

>ne
You follow the garden path around to the front of the cottage.

North Of The Cottage
You stand in front of a large two storey cottage. Cornfields are to the North. A path leads around the side of the cottage to the southwest.

>n
The Cornfields
You are standing in a field of corn. To the north is a wooden gate leading to a farm path. A cottage lies to the south.

An old rotting wooden post is here. 

On the post is a note.

>read note
There is a message inscribed onto the note in what looks like charcoal. The author has used aggressive straight lines to etch out each letter. The message reads:

 "Your place is in the fields"

>s
North Of The Cottage
You stand in front of a large two storey cottage. Cornfields are to the North. A path leads around the side of the cottage to the southwest.  You see a strange figure at the window  

You can see something pinned to the post where the scarecrow used to be.

>n
The Cornfields
You are standing in a field of corn. To the north is a wooden gate leading to a farm path. A cottage lies to the south.

An old rotting wooden post is here. 

On the post is a note.

>examine note
There is a message inscribed onto the note in what looks like charcoal. The author has used aggressive straight lines to etch out each letter. The message reads:

 "Your place is in the fields"

>s
North Of The Cottage
You stand in front of a large two storey cottage. Cornfields are to the North. A path leads around the side of the cottage to the southwest.  You see a strange figure at the window  

You can see something pinned to the post where the scarecrow used to be.

* * *

>ne
You follow the garden path around to the front of the cottage.

North Of The Cottage
You stand in front of a large two storey cottage. Cornfields are to the North. A path leads around the side of the cottage to the southwest.

>sw
You follow garden path to the back of the cottage.

South of the Cottage
You are standing behind the cottage.

There is an old plough here.

* * *

>get key
As you pick up the key, you hear four loud bangs coming from the front of the cottage.

>ne
You follow the garden path around to the front of the cottage.

North Of The Cottage
You stand in front of a large two storey cottage. Cornfields are to the North. A path leads around the side of the cottage to the southwest.    OMG THE POST!

>n
The Cornfields
You are standing in a field of corn. To the north is a wooden gate leading to a farm path. A cottage lies to the south.

An old rotting wooden post is here. 

On the post is a note.

You feel a cool breeze.

>look
The Cornfields
You are standing in a field of corn. To the north is a wooden gate leading to a farm path. A cottage lies to the south.

An old rotting wooden post is here. 

On the post is a note.

You feel a cool breeze.

* * *

>sw
You follow garden path to the back of the cottage.

South of the Cottage
You are standing behind the cottage.

There is an old plough here.

>examine plough
It is an old plough.

resting on the plough, you see a rusty key.

>examine key
An old, rusty key.

>get key
Taken.

>ne
You follow the garden path around to the front of the cottage.

North Of The Cottage
You stand in front of a large two storey cottage. Cornfields are to the North. A path leads around the side of the cottage to the southwest.

>n
The Cornfields
You are standing in a field of corn. To the north is a wooden gate leading to a farm path. A cottage lies to the south.

An old rotting wooden post is here. Popped up against the post is a hideous scarecrow.

* * *

>x plough
It is an old plough.

resting on the plough, you see a rusty key.

>get key
 You hear four loud bangs coming from the front of the cottage.

Taken.

* * *

>s
North Of The Cottage
You stand in front of a large two storey cottage. Cornfields are to the North. A path leads around the side of the cottage to the southwest. You feel unseen eyes watching you.

>nw
You can't go that way.

>n
The Cornfields
You are standing in a field of corn. To the north is a wooden gate leading to a farm path. A cottage lies to the south.

An old rotting wooden post is here. Popped up against the post is a hideous scarecrow.

* * *

>sw
You follow garden path to the back of the cottage.

South of the Cottage
You are standing behind the cottage.

There is an old plough here.

>ne
You follow the garden path around to the front of the cottage.

OMG the scarecrow dissapeared!

North Of The Cottage
You stand in front of a large two storey cottage. Cornfields are to the North. A path leads around the side of the cottage to the southwest.    

To the north you can see something pinned to the post where the scarecrow used to be.

You feel a cool breeze.

>n
The Cornfields
You are standing in a field of corn. To the north is a wooden gate leading to a farm path. A cottage lies to the south.

An old rotting wooden post is here. 

On the post is a note.

>get note
Taken.

>s
North Of The Cottage
You stand in front of a large two storey cottage. Cornfields are to the North. A path leads around the side of the cottage to the southwest.

>n
The Cornfields
You are standing in a field of corn. To the north is a wooden gate leading to a farm path. A cottage lies to the south.

An old rotting wooden post is here.

* * *

>s
(first opening the wooden gate)

The Cornfields
You are standing in a field of corn. To the north is a wooden gate leading to a farm path. A cottage lies to the south.

An old rotting wooden post is here. Popped up against the post is a hideous scarecrow.

You hear a crow above.

>sw
The fields of corn stretch out as far as the eye can see. The only exit is the path to the North.

>s
North Of The Cottage
You stand in front of a large two storey cottage. Cornfields are to the North. A path leads around the side of the cottage to the southwest. You feel unseen eyes watching you.

* * *

The Scarecrow
An exploration of war and belonging by Mikey Hogarth The story genre is "Horror"
Release 1 / Serial number 130919 / Inform 7 build 6G60 (I6/v6.32 lib 6/12N) SD

The Farm Path
You are standing on a muddy farm path. A wooden gate to the south leads into a large barley field which forms part of a patchwork vista of yellow and brown draped over the distant landscape. The fields are separated by deep green foliage. 

Your journey here has been long and tiring. Beyond the field to the south you can see a thatched-roof cottage, a place you had once felt a connection with. A place you had once called home. In spite of your aching feet, the cottage no longer feels like an inviting respite. 

The weather is overcast and a gentle rain is falling, casting a damp film across the landscape.  

You see a small black cat sheltering under some nearby foliage.

>x foliage
Deep green foliage forms barriers between fields.

I beg your pardon?

>l
The Farm Path
A wooden gate to the south leads to the cornfields.

>x path
A well trodden farm path stretches in an east to westerly direction.

You feel a cool breeze.

>x sky
Dull, grey clouds hang overhead.

I beg your pardon?

* * *

>look east
You see nothing unexpected in that direction.

* * *

I beg your pardon?

>x cat
The cat stares at you with wide yellow eyes which convey both curiosity and caution in equal measures.

* * *

I beg your pardon?

>x
What do you want to examine?

I beg your pardon?

* * *

>stroke cat
As you approach the cat, it flees into the undergrowth.

>s
(first opening the wooden gate)

The Barley Field
As you enter the barley field, your mind drifts to the fields of battle in the aftermath of Waterloo. The casualties were horrendous, the victory far from glorious. Many of the soldiers who died that day, the "scum of the earth" as Wellington had described them, had been recruited from villages and hamlets nearby. Wellington had later claimed  that it was "really wonderful that we should have made these men into the fine fellows they are." You consider the barrenness of that statement  now that tens of thousands of those fine fellows were dead. Many of those who survived were not the same as they were before the war, having succumbed to war exhaustion or madness, or worse.

The chill wind is making it hard to breathe, and you begin to feel light headed. Further south through the fields you can see the old farm cottage. 

An old rotting wooden post is here. Propped up against the post, standing to attention, is a lone scarecrow.

>s
Front Of The Cottage
You approach the front of a large two storey cottage that is very familiar to you. A field of barley lies to the North. A path leads around the side of the cottage to the southwest. The cottage itself is directly south, the entrance blocked by a heavy oak door.   

The small black cat from the farm path is here, washing himself among the barley.

>stroke cat
The cat seems more comfortable around you now.

the cat meows.

>wait
Time passes.

The Cat heads north to The Barley Field.

* * *

>pet cat
I only understood you as far as wanting to pet.

* * *

>touch cat
As you approach the cat, it flees into the undergrowth.

You hear the harsh "caw" of a crow.

>s
(first opening the wooden gate)

The Barley Field
As you enter the barley field, your mind drifts to the fields of battle in the aftermath of Waterloo. The casualties were horrendous, the victory far from glorious. Many of the soldiers who died that day, the "scum of the earth" as Wellington had described them, had been recruited from villages and hamlets nearby. Wellington had later claimed  that it was "really wonderful that we should have made these men into the fine fellows they are." You consider the barrenness of that sentiment now that tens of thousands of those fine fellows are dead. Many of those who survived were not the same people they once were, with some succumbing to war exhaustion and others to madness or worse.

And what of yourself? Are you a soldier or a farm-hand? Is a return to your old life a possibility or is something within your very soul broken beyond repair? What does a soldier do when there is nothing left to fight for? The chill wind is making it hard to breathe, and you begin to feel light headed. Further south through the fields you can see the old farm cottage. 

An old rotting wooden post is here. Propped up against the post, standing to attention, is a lone scarecrow.

I beg your pardon?

>s
Front Of The Cottage
You approach the front of a large two storey cottage. A field of barley lies to the North. A path leads around the side of the cottage to the southwest.    

The small black cat from the farm path is here, washing himself among the barley.

>pet cat
The cat seems more comfortable around you now.

>x collar
The cats name is Wellington.

>wait
Time passes.

You feel a cool breeze.

>wait
Time passes.

>z
Time passes.

* * *

>z
Time passes.

Aww what an epic cat.
He is epic.

* * *

The Scarecrow
An exploration of war and belonging by Mikey Hogarth The story genre is "Horror"
Release 1 / Serial number 130916 / Inform 7 build 6G60 (I6/v6.32 lib 6/12N) SD

The Farm Path
You are standing on a muddy farm path. A wooden gate to the south leads into a large barley field which forms part of a patchwork vista of yellow and brown draped over the distant landscape. The fields are separated by deep green foliage. 

Your journey here has been long and tiring. Beyond the field to the south you can see a thatched-roof cottage, a place you had once felt a connection with. A place you had once called home. In spite of your aching feet, the cottage no longer feels like an inviting respite. 

The weather is overcast and a gentle rain is falling.  

You see a small black cat sheltering under some nearby foliage.

I beg your pardon?

>kick cat
As you approach the cat, it flees into the undergrowth.

You hear the harsh "caw" of a crow.

>s
(first opening the wooden gate)

The Barley Field
As you enter the barley field, your mind drifts to the fields of battle in the aftermath of Waterloo. The casualties were horrendous, the victory far from glorious. Many of the soldiers who died that day, the "scum of the earth" as Wellington had described them, had been recruited from villages and hamlets nearby. Wellington had later claimed  that it was "really wonderful that we should have made these men into the fine fellows they are." You consider the barrenness of that sentiment now that tens of thousands of those fine fellows are dead. Many of those who survived were not the same people they once were, with some succumbing to war exhaustion and others to madness or worse.

And what of yourself? Are you a soldier or a farm-hand? Is a return to your old life a possibility or is something within your very soul broken beyond repair? What does a soldier do when there is nothing left to fight for?

The chill wind is making it hard to breathe, and you begin to feel light headed. Further south through the fields you can see the old farm cottage. 

The small black cat is here. 

An old rotting wooden post is here. Propped up against the post, standing to attention, is a lone scarecrow.

* * *

>s
(first opening the wooden gate)

The Cornfields
You are standing in a field of corn. To the north is a wooden gate leading to a farm path. A cottage lies to the south.

An old rotting wooden post is here. Popped up against the post is a hideous scarecrow.

>x scarecrow
Yeah, it's one of the scary ones.

>x corn
It's some corn.

>x corn
It's some corn.

>l
The Cornfields
You are standing in a field of corn. To the north is a wooden gate leading to a farm path. A cottage lies to the south.

An old rotting wooden post is here. Popped up against the post is a hideous scarecrow.

>push scarecrow
It is fixed in place.

You feel a cool breeze.

>move scarecrow
It is fixed in place.

>s
North Of The Cottage
You stand in front of a large two storey cottage. Cornfields are to the North. A path leads around the side of the cottage to the southwest. You feel unseen eyes watching you.   

You hear a crow above.

* * *

Everything is supposed to be very quiet after a massacre, and it always is, except for the birds. And what do the birds say? All there is to say about a massacre, things like "Poo-tee-weet". -- Kurt Vonnegut

Please press SPACE to continue.

>open gate
You open the wooden gate.

>s
The Cornfields
You are standing in a field of corn. To the north is a wooden gate leading to a farm path. A cottage lies to the south.

An old rotting wooden post is here. Propped up against the post is a hideous scarecrow.

You feel a cool breeze.

>x scarecrow
Yeah, it's one of the scary ones.

>x cottage
The large cottage is comprised of two floors. It is reddish-beige in colour has a thatched roof. A heavy and weather-worn oak door at the front of the cottage serves as the entrance.

You feel a cool breeze.

>open door
You can't see any such thing.

>s
Front Of The Cottage
You stand in front of a large two storey cottage. Cornfields are to the North. A path leads around the side of the cottage to the southwest. 

You feel unseen eyes watching you.

>enter cottage
(first opening the Front Door)
You heave with all of your might but the heavy oak door will not budge.

It seems to be locked.

>se
You follow garden path to the back of the cottage.

Back of the Cottage
You are standing behind the cottage.

There is an old plough here.

>x plough
It is an old plough.

resting on the plough, you see a rusty key.

* * *

>get key
As you pick up the key, you hear four loud bangs coming from the front of the cottage.

>ne
You follow the garden path around to the front of the cottage.

Front Of The Cottage
You stand in front of a large two storey cottage. Cornfields are to the North. A path leads around the side of the cottage to the southwest.    OMG THE POST!

>n
The Cornfields
You are standing in a field of corn. To the north is a wooden gate leading to a farm path. A cottage lies to the south.

An old rotting wooden post is here. 

On the post is a note.

You feel a cool breeze.

>look at post
The old wooden post is a brownish green colour and is damp to the touch.

On the post is a note.

>read note
There is a message inscribed onto the note in what looks like charcoal. The author has used aggressive straight lines to etch out each letter. The message reads:

 "Your place is in the fields"

You hear a crow above.

>get note
Taken.

You feel a cool breeze.

>s
Front Of The Cottage
You stand in front of a large two storey cottage. Cornfields are to the North. A path leads around the side of the cottage to the southwest.  You see a strange figure at the window  

You feel a cool breeze.

>look at figure
You see a strange figure at the window.

As your eyes begin to focus more clearly, the figure fades from view. Was it even there in the first place?

>use key on door
That's not a verb I recognise.

>unlock door
What do you want to unlock the Front Door with?

* * *

>key
You unlock the Front Door.

>enter cottage
(first opening the Front Door)

The Lobby
 As you enter the cottage, you feel nauseous and short of breath. Surfaces feel cold and damp to the touch.   You are in the lobby. The room is large and mostly empty, save for a few shelves.

You can see a shelf (on which is a clock) here.

>x clock
The time reads eighteen minutes past three.

>x clock
The time reads nineteen minutes past three.

* * *

I beg your pardon?

>s
(first opening the wooden gate)

The Cornfields
You are standing in a field of corn. To the north is a wooden gate leading to a farm path. A cottage lies to the south.

An old rotting wooden post is here. Propped up against the post is a hideous scarecrow.

>n
The Farm Path
You are standing on a dusty and well-trodden farm path. To the south is a wooden gate, over which you can see a thatched-roof cottage. A patchwork vista of green and yellow cornfields is draped over the distant hills.

* * *

>l
The Farm Path
A wooden gate to the south leads to a field of barley.

A small black cat is sheltering under a bush beside the path.

You hear the harsh "caw" of a crow.

>l
The Farm Path
 It's the path dummy.

You feel a cool breeze.

>s
(first opening the wooden gate)

The Cornfields
You are standing in a field of corn. To the north is a wooden gate leading to a farm path. A cottage lies to the south.

An old rotting wooden post is here. Propped up against the post is a hideous scarecrow.

>n
The Farm Path
 It's the path dummy.

* * *

>l
The Farm Path
A wooden gate to the south leads to a field of barley.

A small black cat is sheltering under a bush beside the path.

You hear the harsh "caw" of a crow.

>touch cat
As you approach the cat, it flees into the undergrowth.

>s
(first opening the wooden gate)

The Barley Field
As you enter the barley field, your mind drifts to the fields of battle in the aftermath of Waterloo. The casualties were horrendous, the victory far from glorious. Many of the soldiers who died that day, the "scum of the earth" as Wellington had described them, had been recruited from villages and hamlets nearby. Wellington had later claimed  that it was "really wonderful that we should have made these men into the fine fellows they are." You consider the barrenness of that sentiment now that tens of thousands of those fine fellows are dead. Many of those who survived were not the same people they once were, with some succumbing to war exhaustion and others to madness or worse.

And what of yourself? Are you a soldier or a farm-hand? Is a return to your old life a possibility or is something within your very soul broken beyond repair? What does a soldier do when there is nothing left to fight for?

The chill wind is making it hard to breathe, and you begin to feel light headed. Further south through the fields you can see the old farm cottage. 

A small black cat is sheltering under a bush beside the path.

An old rotting wooden post is here. Propped up against the post, standing to attention, is a lone scarecrow.

You feel a cool breeze.

* * *

>x weather
Dull, grey clouds hang overhead.

>x sky
Dull, grey clouds hang overhead.

>x crows
You can't see any such thing.

* * *

>x crows
Yay, crows.

>x birds
Yay, crows.

* * *

>x cat
The cat stares at you with wide yellow eyes which convey both curiosity and caution in equal measures.

The cat meows.

>pet cat
As you approach the cat, it flees into the undergrowth.

>l
The Farm Path
A wooden gate to the south leads to the cornfields.

>x cat
You can't see any such thing.

* * *

>x cat
The cat stares at you with wide yellow eyes which convey both curiosity and caution in equal measures.

The cat meows.

>touch cat
As you approach the cat, it flees into the undergrowth.

>s
(first opening the wooden gate)

The Barley Field
As you enter the barley field, your mind drifts to the fields of battle in the aftermath of Waterloo. The casualties were horrendous, the victory far from glorious. Many of the soldiers who died that day, the "scum of the earth" as Wellington had described them, had been recruited from villages and hamlets nearby. Wellington had later claimed  that it was "really wonderful that we should have made these men into the fine fellows they are." You consider the barrenness of that sentiment now that tens of thousands of those fine fellows are dead. Many of those who survived were not the same people they once were, with some succumbing to war exhaustion and others to madness or worse.

And what of yourself? Are you a soldier or a farm-hand? Is a return to your old life a possibility or is something within your very soul broken beyond repair? What does a soldier do when there is nothing left to fight for?

The chill wind is making it hard to breathe, and you begin to feel light headed. Further south through the fields you can see the old farm cottage. 

The small black cat from earlier emerges from the barley fields and sniffs the air.

An old rotting wooden post is here. Propped up against the post, standing to attention, is a lone scarecrow.

>wait
Time passes.

>x cat
The cat stares at you with wide yellow eyes which convey both curiosity and caution in equal measures.

You hear the harsh "caw" of a crow.

>touch cat
As you approach the cat, it flees into the undergrowth.

You feel a cool breeze.

>l
The Barley Field
You are standing in a field of barley. To the north is a wooden gate leading to a farm path. A cottage lies to the south.

There is a small black cat here.

An old rotting wooden post is here. Propped up against the post, standing to attention, is a lone scarecrow.

You hear the harsh "caw" of a crow.

* * *

>x cat
The cat seems more comfortable around you now.

>stroke cat
Keep your hands to yourself!

* * *

>x cat
The cat stares at you with wide yellow eyes which convey both curiosity and caution in equal measures.

The cat meows.

>stroke cat
As you approach the cat, it flees into the undergrowth.

>s
(first opening the wooden gate)

The Barley Field
As you enter the barley field, your mind drifts to the fields of battle in the aftermath of Waterloo. The casualties were horrendous, the victory far from glorious. Many of the soldiers who died that day, the "scum of the earth" as Wellington had described them, had been recruited from villages and hamlets nearby. Wellington had later claimed  that it was "really wonderful that we should have made these men into the fine fellows they are." You consider the barrenness of that sentiment now that tens of thousands of those fine fellows are dead. Many of those who survived were not the same people they once were, with some succumbing to war exhaustion and others to madness or worse.

The chill wind is making it hard to breathe, and you begin to feel light headed. Further south through the fields you can see the old farm cottage. 

An old rotting wooden post is here. Propped up against the post, standing to attention, is a lone scarecrow.

>x cat
You can't see any such thing.

>stroke cat
The cat purrs loudly.

>pet cat
The cat rubs its face against your leg.

* * *

>x cat
You can't see any such thing.

>n
The Farm Path
A wooden gate to the south leads to a field of barley. 

You see a small black cat sheltering under some nearby foliage.

The cat begins scratching in the undergrowth.

* * *

>x post
The old wooden post is a brownish green colour and is damp to the touch.

>x scarecrow
The scarecrow is wearing a tattered red coat and a pair of old grey trousers. Black wellingtons and a shapeless cloth hat with a wide, crinkly brim complete the outfit.

The scarecrow's head is made from a hessian sack, onto which has been drawn the approximation of a face. You can not tell whether the scarecrow is smiling or frowning. His eyes stare blankly through you. The scarecrow is soaked through with rain, signifying that he has been standing in the field for some time.

As you stare at the scarecrow, you feel a deep nausea as you come to accept an affinity with him. The fields he defends have been ravaged by disease and the farmland has clearly been abandoned. His battlefield is a barren waste, his war a lost cause. He has been standing here so long, the crows are no longer afraid of him. Perhaps now the fight is over, they are his only companions.

You feel a cool breeze.

>s
Front Of The Cottage
You approach the front of a large two storey cottage. A field of barley lies to the North. A path leads around the side of the cottage to the southwest.    

The small black cat from the farm path is here, washing himself among the barley.

>x cat
The cat stares at you with wide yellow eyes which convey both curiosity and caution in equal measures.

The cat begins scratching in the undergrowth.

>l
Front Of The Cottage
You stand in front of a large two storey cottage. A field of barley lies to the North. A path leads around the side of the cottage to the southwest.    

The small black cat from the farm path is here, washing himself among the barley.

You hear the harsh "caw" of a crow.

>stroke cat
You feel a cool breeze.

The cat meows.

>l
Front Of The Cottage
You stand in front of a large two storey cottage. A field of barley lies to the North. A path leads around the side of the cottage to the southwest.    

You can see a cat here.

>x cat
The cat seems more comfortable around you now.

You hear the harsh "caw" of a crow.

>stroke cat
The cat begins scratching in the undergrowth.

* * *

>x scarecrow
The scarecrow is wearing a tattered red coat and a pair of old grey trousers. Black rubber boots and a shapeless cloth hat with a wide, crinkly brim complete the outfit.

The scarecrow's head is made from a hessian sack, onto which has been drawn the approximation of a face. You can not tell whether the scarecrow is smiling or frowning. His eyes stare blankly through you. The scarecrow is soaked through with rain, signifying that he has been standing in the field for some time.

As you stare at the scarecrow, you feel a deep nausea as you come to accept an affinity with him. The fields he defends have been ravaged by disease and the farmland has clearly been abandoned. His battlefield is a barren waste, his war over. He has been standing here so long, the crows are no longer afraid of him. Perhaps now the fight is over, they are his only companions.

You feel a cool breeze.

>s
Front Of The Cottage
You approach the front of a large two storey cottage that is very familiar to you. A field of barley lies to the North. A path leads around the side of the cottage to the southwest. The cottage itself is directly south, the entrance blocked by a heavy oak door.   

The small black cat from the farm path is here, washing himself among the barley.

The cat meows.

>wait
Time passes.

The cat begins scratching in the undergrowth.

>wait
Time passes.

You hear the harsh "caw" of a crow.

>stroke cat
The cat seems more comfortable around you now.

The cat heads southeast to Back of the Cottage.

>wait
Time passes.

>se
You follow garden path to the back of the cottage.

Back of the Cottage
You are standing behind the cottage.

There is an old plough here.

You can also see The cat here.

* * *

>stroke cat
As you approach the cat, it flees into the undergrowth.

>look
The Farm Path
A wooden gate to the south leads to a field of barley.

>x path
A well trodden farm path stretches in an east to westerly direction.

>s
(first opening the wooden gate)

The Barley Field
As you enter the barley field, your mind drifts to the fields of battle in the aftermath of Waterloo. The casualties were horrendous, the victory far from glorious. Many of the soldiers who died that day, the "scum of the earth" as Wellington had described them, had been recruited from villages and hamlets nearby. Wellington had later claimed  that it was "really wonderful that we should have made these men into the fine fellows they are." You consider the barrenness of that statement  now that tens of thousands of those fine fellows were dead. Many of those who survived were not the same as they were before the war, having succumbed to war exhaustion or madness, or worse.

The chill wind is making it hard to breathe, and you begin to feel light headed. Further south through the fields you can see the old farm cottage. 

An old rotting wooden post is here. Propped up against the post, standing to attention, is a lone scarecrow.

>x scarecrow
The scarecrow is wearing a tattered red coat and a pair of old grey trousers. Black rubber boots and a shapeless cloth hat with a wide, crinkly brim complete the outfit.

The scarecrow's head is made from a hessian sack, onto which has been drawn the approximation of a face. You can not tell whether the scarecrow is smiling or frowning, and his eyes stare blankly through you. The scarecrow is soaked through with rain - he has clearly been standing in this field for some time.

As you stare at the scarecrow, you feel a deep nausea as you come to accept an affinity with him. You consider the folly in his defence of fields that have been abandoned and ravaged by disease. His battlefield is a barren waste, his war over. He has been standing here so long, the crows are no longer afraid of him. Perhaps now the fight is over, they are his only companions.

>x crows
Yay, crows.

>x post
The old wooden post is a brownish green colour and is damp to the touch.

>get scarecrow
I don't suppose the scarecrow would care for that.

>get post
That's fixed in place.

>get crows
That's hardly portable.

* * *

>get cat
As you approach the cat, it flees into the undergrowth.

You feel a cool breeze.

>pet cat
That's not a verb I recognise.

>touch cat
Keep your hands to yourself!

* * *

>get cat
As you approach the cat, it flees into the undergrowth.

You feel a cool breeze.

>touch cat
Keep your hands to yourself!

>pet cat
Keep your hands to yourself!

>kick cat
That's not a verb I recognise.

>attack cat
Violence isn't the answer to this one.

You hear a crow above.

* * *

>n
The Farm Path
A wooden gate to the south leads to a field of barley. 

You see a small black cat sheltering under some nearby foliage.

the cat meows.

>touch cat
As you approach the cat, it flees into the undergrowth.

>kick cat
Violence isn't the answer to this one.

You hear a crow above.

>punch cat
Violence isn't the answer to this one.

* * *

>touch cat
As you approach the cat, it flees into the undergrowth.

>s
The Barley Field
You are standing in a field of barley. To the north is a wooden gate leading to a farm path. A cottage lies to the south.

An old rotting wooden post is here. Propped up against the post, standing to attention, is a lone scarecrow.

You feel a cool breeze.

>l
The Barley Field
You are standing in a field of barley. To the north is a wooden gate leading to a farm path. A cottage lies to the south.

An old rotting wooden post is here. Propped up against the post, standing to attention, is a lone scarecrow.

You can also see a He's in the fieldA small black cat here.

You hear the harsh "caw" of a crow.

* * *

>s
The Barley Field
You are standing in a field of barley. To the north is a wooden gate leading to a farm path. A cottage lies to the south.

An old rotting wooden post is here. Propped up against the post, standing to attention, is a lone scarecrow.

You feel a cool breeze.

>s
Front Of The Cottage
You approach the front of a large two storey cottage. A field of barley lies to the North. A path leads around the side of the cottage to the southwest.    

The small black cat from the farm path is here, washing himself among the barley.

>touch cat
The cat seems more comfortable around you now.

>z
Time passes.

He heads north to The Barley Field.

* * *

>x scarecrow
The scarecrow is wearing a tattered red coat and a pair of old grey trousers. Black wellingtons and a shapeless cloth hat with a wide, crinkly brim complete the outfit.

The scarecrow's head is made from a hessian sack, onto which has been drawn the approximation of a face. You can not tell whether the scarecrow is smiling or frowning. His eyes stare blankly through you. The scarecrow is soaked through with rain, signifying that he has been standing in the field for some time.

As you stare at the scarecrow, you feel a deep nausea as you come to accept an affinity with him. The fields he defends have been ravaged by disease and the farmland has clearly been abandoned. His battlefield is a barren waste, his war a lost cause. He has been standing here so long, the crows are no longer afraid of him. Perhaps now the fight is over, they are his only companions.

>l
The Barley Field
You are standing in a field of barley. To the north is a wooden gate leading to a farm path. A cottage lies to the south.

An old rotting wooden post is here. Propped up against the post, standing to attention, is a lone scarecrow.

You hear the harsh "caw" of a crow.

>n
The Farm Path
A wooden gate to the south leads to a field of barley.

A small black cat is sheltering under a bush beside the path.

>l
The Farm Path
A wooden gate to the south leads to a field of barley.

A small black cat is sheltering under a bush beside the path.

>s
The Barley Field
You are standing in a field of barley. To the north is a wooden gate leading to a farm path. A cottage lies to the south.

An old rotting wooden post is here. Propped up against the post, standing to attention, is a lone scarecrow.

>e
The fields of corn seem to go on forever and there would be little point in entering them. The only exits are North towards the farm path and south towards the cottage.

* * *

>x crow
Yay, crows.

You hear the harsh "caw" of a crow.

>s
Front Of The Cottage
You stand in front of a large two storey cottage. A field of barley lies to the North. A path leads around the side of the cottage to the southwest. 

You feel unseen eyes watching you.

>x barley
Acres of barley, wheat and oat stretch over the horizon. Reaping is long overdue in many of the fields.

You feel a cool breeze.

* * *

>scarecrow
Which do you mean, the scarecrow or the scarecrows outfit?

* * *

>x boots
A muddy black pair of wellingtons.

>x coat
A tattered red coat.

>get coat
That seems to belong to the scarecrow.

>s
Front Of The Cottage
You stand in front of a large two storey cottage. A field of barley lies to the North. A path leads around the side of the cottage to the southwest. 

You feel unseen eyes watching you.

* * *

>enter field
You can't see any such thing.

>enter fields of corn
The fields of corn seem to go on forever and there would be little point in entering them. The only exits are North towards the farm path and south towards the cottage.

* * *

>s
Front Of The Cottage
You approach the front of a large two storey cottage that is very familiar to you. A field of barley lies to the North. A path leads around the side of the cottage to the southwest. The cottage itself is directly south, the entrance blocked by a heavy oak door.   

You hear the harsh "caw" of a crow.

>s
(first opening the Front Door)
You heave with all of your might but the heavy oak door will not budge.

It seems to be locked.

>l
Front Of The Cottage
You stand in front of a large two storey cottage. A field of barley lies to the North. A path leads around the side of the cottage to the southwest.

>examine eyes
You can't see any such thing.

>l
Front Of The Cottage
You stand in front of a large two storey cottage. A field of barley lies to the North. A path leads around the side of the cottage to the southwest.

>n
The Barley Field
You are standing in a field of barley. To the north is a wooden gate leading to a farm path. A cottage lies to the south.

An old rotting wooden post is here. Propped up against the post, standing to attention, is a lone scarecrow.

>x scarecrow
The scarecrow is wearing a tattered red coat and a pair of old grey trousers. Black wellingtons and a shapeless cloth hat with a wide, crinkly brim complete the outfit.

The scarecrow's head is made from a hessian sack, onto which has been drawn the approximation of a face. You can not tell whether the scarecrow is smiling or frowning. His eyes stare blankly through you.

As you stare at the scarecrow, you feel a deep nausea as you come to accept an affinity with him. The fields he defends have been ravaged by disease and the farmland has clearly been abandoned. His battlefield is a barren waste, his war a lost cause. He has been standing here so long, the crows are no longer afraid of him. Perhaps now the fight is over, they are his only companions.

>x scarecrow
The scarecrow is wearing a tattered red coat and a pair of old grey trousers. Black wellingtons and a shapeless cloth hat with a wide, crinkly brim complete the outfit.

The scarecrow's head is made from a hessian sack, onto which has been drawn the approximation of a face. You can not tell whether the scarecrow is smiling or frowning. His eyes stare blankly through you.

* * *

>l
Front Of The Cottage
You stand in front of a large two storey cottage. A field of barley lies to the North. A path leads around the side of the cottage to the southwest.

>sw
You follow garden path to the back of the cottage.

Back of the Cottage
You are standing behind the cottage.

There is an old plough here.

>ne
You follow the garden path around to the front of the cottage.

Front Of The Cottage
You stand in front of a large two storey cottage. A field of barley lies to the North. A path leads around the side of the cottage to the southwest.    

You hear the harsh "caw" of a crow.

>n
The Barley Field
You are standing in a field of barley. To the north is a wooden gate leading to a farm path. A cottage lies to the south.

An old rotting wooden post is here. Propped up against the post, standing to attention, is a lone scarecrow.

* * *

>n
The Farm Path
A wooden gate to the south leads to a field of barley. 

You see a small black cat sheltering under some nearby foliage.

>x cat
The cat stares at you with wide yellow eyes which convey both curiosity and caution in equal measures.

>stroke cat
As you approach the cat, it flees into the undergrowth.

You feel a cool breeze.

>s
The Barley Field
You are standing in a field of barley. To the north is a wooden gate leading to a farm path. A cottage lies to the south.

An old rotting wooden post is here. Propped up against the post, standing to attention, is a lone scarecrow.

>s
Front Of The Cottage
You stand in front of a large two storey cottage. A field of barley lies to the North. A path leads around the side of the cottage to the southwest.    

The small black cat from the farm path is here, washing himself among the barley.

The cat meows.

>x barley
Acres of barley, wheat and oat stretch over the horizon. The fields are wild and unkempt. Many of the crops have been ravaged by disease.

>x cat
A small black cat with wide, yellow eyes. The cat is wearing a silver collar.

>x collar
You see nothing special about the silver collar.

>stroke cat
The cat seems more comfortable around you now.

>l
Front Of The Cottage
You stand in front of a large two storey cottage. A field of barley lies to the North. A path leads around the side of the cottage to the southwest.    

You can see a cat here.

The cat begins scratching in the undergrowth.

* * *

>s
(first opening the Front Door)
You heave with all of your might but the heavy oak door will not budge.

It seems to be locked.

>sw
You follow garden path to the back of the cottage.

Back of the Cottage
You are standing behind the cottage.

There is an old plough here.

* * *

>x plough
It is an old plough.

resting on the plough, you see a rusty key.

>get key
As you pick up the key, your heart jolts - you hear four loud bangs coming from the front of the cottage, like metal knocking on wood. The sound echoes around the hills and then all is silent again.

>ne
You follow the garden path around to the front of the cottage.

Front Of The Cottage
You stand in front of a large two storey cottage . A field of barley lies to the North. A path leads around the side of the cottage to the southwest. The cottage itself is directly south, the entrance blocked by a heavy oak door. 

As you make your way around the front of the cottage, you survey the area to see if you can identify the cause of the banging. Just as you are about to resign to having imagined the sound, you observe to your horror that the field to the north is now empty. The scarecrow has left his post.. You can vaguely make out that something has been nailed to the post in place of the scarecrow, flapping gently in the breeze.

>s
(first opening the Front Door)
You heave with all of your might but the heavy oak door will not budge.

It seems to be locked.

>unlock door with key
You unlock the Front Door.

You feel a cool breeze.

>s
(first opening the Front Door)

The Lobby
 As you enter the cottage, you feel nauseous and short of breath. Surfaces feel cold and damp to the touch.   You are in the lobby. The room is large and mostly empty, save for a few shelves.

You can see a shelf (on which is a clock) here.

>n
Front Of The Cottage
You stand in front of a large two storey cottage . A field of barley lies to the North. A path leads around the side of the cottage to the southwest. The cottage itself is directly south, the entrance blocked by a heavy oak door. 

In the field to the north you can see something nailed to a post.

>close door
You close the Front Door.

>open door
You open the Front Door.

* * *

>s
Front Of The Cottage
You approach the front of a large two storey cottage that is very familiar to you. A field of barley lies to the North. A path leads around the side of the cottage to the southwest. The cottage itself is directly south, the entrance blocked by a heavy oak door.   

You hear the harsh "caw" of a crow.

>sw
You follow garden path to the back of the cottage.

Back of the Cottage
You are standing behind the cottage.

There is an old plough here.

* * *

>l
The Barley Field
You are standing in a field of barley. To the north is a wooden gate leading to a farm path. A cottage lies to the south.

An old rotting wooden post is here. Propped up against the post, standing to attention, is a lone scarecrow.

>x scarecrow
The scarecrow is wearing a tattered red coat and a pair of old grey trousers. Black wellingtons and a shapeless cloth hat with a wide, crinkly brim complete the outfit.

The scarecrow's head is made from a hessian sack, onto which has been drawn the approximation of a face. You can not tell whether the scarecrow is smiling or frowning. His eyes stare blankly through you. The scarecrow is soaked through with rain, signifying that he has been standing in the field for some time.

As you stare at the scarecrow, you feel a deep nausea as you come to accept an affinity with him. The fields he defends have been ravaged by disease and the farmland has clearly been abandoned. His battlefield is a barren waste, his war a lost cause. He has been standing here so long, the crows are no longer afraid of him. Perhaps now the fight is over, they are his only companions.

>x hat
You see nothing special about the hat.

* * *

>pet cat
As you approach the cat, it flees into the undergrowth.

You hear the harsh "caw" of a crow.

* * *

>look east
You see nothing unexpected in that direction.

>look west
You see nothing unexpected in that direction.

You hear the harsh "caw" of a crow.

>look north
You see nothing unexpected in that direction.

>look west
You see nothing unexpected in that direction.

>look at fields
Acres of barley, wheat and oat stretch over the horizon. Reaping is long overdue in many of the fields.

>go south
(first opening the wooden gate)

The Barley Field
As you enter the barley field, your mind drifts to the fields of battle in the aftermath of Waterloo. The casualties were horrendous, the victory far from glorious. Many of the soldiers who died that day, the "scum of the earth" as Wellington had described them, had been recruited from villages and hamlets nearby. Wellington had later claimed  that it was "really wonderful that we should have made these men into the fine fellows they are." You consider the barrenness of that sentiment now that tens of thousands of those fine fellows are dead. Many of those who survived were not the same people they once were, with some succumbing to war exhaustion and others to madness or worse.

And what of yourself? Are you a soldier or a farm-hand? Is a return to your old life a possibility or is something within your very soul broken beyond repair? What does a soldier do when there is nothing left to fight for?

The chill wind is making it hard to breathe, and you begin to feel light headed. Further south through the fields you can see the old farm cottage. 

An old rotting wooden post is here. Propped up against the post, standing to attention, is a lone scarecrow.

>look at post
The old wooden post is a brownish green colour and is damp to the touch.

>look up
You see nothing unexpected in that direction.

>x scarecrow
The scarecrow is wearing a tattered red coat and a pair of old grey trousers. Black wellingtons and a shapeless cloth hat with a wide, crinkly brim complete the outfit.

The scarecrows" head is made from a hessian sack, onto which has been drawn the approximation of a face. You can not tell whether the scarecrow is smiling or frowning. His eyes stare blankly through you.

As you stare at the scarecrow, you feel a deep nausea as you come to accept an affinity for him. The fields he defends have been ravaged by disease and the farmland has clearly been abandoned. His battlefield is a barren waste, his war a lost cause. He has been standing here so long, the crows are no longer afraid of him. Perhaps now they are his only friends.

>go to cottage
You can't see any such thing.

>x scarecrowl
The scarecrow is wearing a tattered red coat and a pair of old grey trousers. Black wellingtons and a shapeless cloth hat with a wide, crinkly brim complete the outfit.

The scarecrows" head is made from a hessian sack, onto which has been drawn the approximation of a face. You can not tell whether the scarecrow is smiling or frowning. His eyes stare blankly through you.

You feel a cool breeze.

>l
The Barley Field
You are standing in a field of barley. To the north is a wooden gate leading to a farm path. A cottage lies to the south.

An old rotting wooden post is here. Propped up against the post, standing to attention, is a lone scarecrow.

>s
Front Of The Cottage
You stand in front of a large two storey cottage. A field of barley lies to the North. A path leads around the side of the cottage to the southwest. 

You feel unseen eyes watching you.   

You hear the harsh "caw" of a crow.

>x cottage
The large cottage is comprised of two floors. It is reddish-beige in colour has a thatched roof. A heavy and weather-worn oak door at the front of the cottage serves as the entrance.

You feel a cool breeze.

>open door
You heave with all of your might but the heavy oak door will not budge.

It seems to be locked.

>sw
You follow garden path to the back of the cottage.

Back of the Cottage
You are standing behind the cottage.

There is an old plough here.

* * *

>get key
As you pick up the key, you hear four loud bangs coming from the front of the cottage.

>ne
You follow the garden path around to the front of the cottage.

Front Of The Cottage
You stand in front of a large two storey cottage. A field of barley lies to the North. A path leads around the side of the cottage to the southwest.    OMG THE POST!

>l
Front Of The Cottage
You stand in front of a large two storey cottage. A field of barley lies to the North. A path leads around the side of the cottage to the southwest.    OMG THE POST!

You hear the harsh "caw" of a crow.

>n
The Barley Field
You are standing in a field of barley. To the north is a wooden gate leading to a farm path. A cottage lies to the south.

An old rotting wooden post is here. 

On the post is a note.

>x post
The old wooden post is a brownish green colour and is damp to the touch.

On the post is a note.

>read note
There is a message inscribed onto the note in what looks like charcoal. The author has used aggressive straight lines to etch out each letter. The message reads:

 "Your place is in the fields"

>s
Front Of The Cottage
You stand in front of a large two storey cottage. A field of barley lies to the North. A path leads around the side of the cottage to the southwest.  You see a strange figure at the window  

To the north you can see something nailed to the post where the scarecrow used to rest. 

You feel a cool breeze.

>x window
You can't see any such thing.

>x strange figure
You see a strange figure at the window.

As your eyes begin to focus more clearly, the figure fades from view. Was it even there in the first place?

>use key
That's not a verb I recognise.

>unlock door
(with the rusty key)
You unlock the Front Door.

You hear the harsh "caw" of a crow.

>enter cottage
(first opening the Front Door)

The Lobby
 As you enter the cottage, you feel nauseous and short of breath. Surfaces feel cold and damp to the touch.   You are in the lobby. The room is large and mostly empty, save for a few shelves.

You can see a shelf (on which is a clock) here.

>x clock
The time reads twenty-six minutes past three.

>x shelf
On the shelf is a clock.

>get clock
The clock is just fine where it is!

>x
(the rusty key)
An old, rusty key.

>look around
You can't see any such thing.

* * *

>look north
You see nothing in that direction. Nearby: the wooden gate
You hear the harsh "caw" of a crow.

>look up
You look up to the sky.

* * *

>x sky
Dull, grey clouds hang overhead.

* * *

>look north
You hear the harsh "caw" of a crow.

>look up
Up.

* * *

>look
The Farm Path
A wooden gate to the south leads to a field of barley.

A small black cat is sheltering under a bush beside the path.

>s
(first opening the wooden gate)

The Barley Field
As you enter the barley field, your mind drifts to the fields of battle in the aftermath of Waterloo. The casualties were horrendous, the victory far from glorious. Many of the soldiers who died that day, the "scum of the earth" as Wellington had described them, had been recruited from villages and hamlets nearby. Wellington had later claimed  that it was "really wonderful that we should have made these men into the fine fellows they are." You consider the barrenness of that sentiment now that tens of thousands of those fine fellows are dead. Many of those who survived were not the same people they once were, with some succumbing to war exhaustion and others to madness or worse.

And what of yourself? Are you a soldier or a farm-hand? Is a return to your old life a possibility or is something within your very soul broken beyond repair? What does a soldier do when there is nothing left to fight for?

The chill wind is making it hard to breathe, and you begin to feel light headed. Further south through the fields you can see the old farm cottage. 

An old rotting wooden post is here. Propped up against the post, standing to attention, is a lone scarecrow.

* * *

>x hat
You can't see any such thing.

>s
(first opening the wooden gate)

The Barley Field
As you enter the barley field, your mind drifts to the fields of battle in the aftermath of Waterloo. The casualties were horrendous, the victory far from glorious. Many of the soldiers who died that day, the "scum of the earth" as Wellington had described them, had been recruited from villages and hamlets nearby. Wellington had later claimed  that it was "really wonderful that we should have made these men into the fine fellows they are." You consider the barrenness of that sentiment now that tens of thousands of those fine fellows are dead. Many of those who survived were not the same people they once were, with some succumbing to war exhaustion and others to madness or worse.

And what of yourself? Are you a soldier or a farm-hand? Is a return to your old life a possibility or is something within your very soul broken beyond repair? What does a soldier do when there is nothing left to fight for?

The chill wind is making it hard to breathe, and you begin to feel light headed. Further south through the fields you can see the old farm cottage. 

An old rotting wooden post is here. Propped up against the post, standing to attention, is a lone scarecrow.

>x hat
A shapeless cloth hat with a wide, crinkly brim.

You hear the harsh "caw" of a crow.

>get hat
That seems to belong to the scarecrow.

* * *

>touch cat
As you approach the cat, it flees into the undergrowth.

* * *

>x cat
The cat stares at you with wide yellow eyes which convey both curiosity and caution in equal measures.

>stroke cat
The cat meows.

>l
The Barley Field
You are standing in a field of barley. To the north is a wooden gate leading to a farm path. A cottage lies to the south.

There is a small black cat here.

An old rotting wooden post is here. Propped up against the post, standing to attention, is a lone scarecrow.

You can also see a cat here.

>x cat
The cat seems more comfortable around you now.

* * *

>l
The Barley Field
You are standing in a field of barley. To the north is a wooden gate leading to a farm path. A cottage lies to the south.

A small black cat is sheltering under a bush beside the path.

An old rotting wooden post is here. Propped up against the post, standing to attention, is a lone scarecrow.

* * *

>look
The Barley Field
You are standing in a field of barley. To the north is a wooden gate leading to a farm path. A cottage lies to the south.

There is a small black cat here.

An old rotting wooden post is here. Propped up against the post, standing to attention, is a lone scarecrow.

* * *

>s
Front Of The Cottage
You approach the front of a large two storey cottage that is very familiar to you. A field of barley lies to the North. A path leads around the side of the cottage to the southwest. The cottage itself is directly south, the entrance blocked by a heavy oak door.   

The small black cat from the farm path is here, washing himself among the barley.

The cat meows.

>l
Front Of The Cottage
You stand in front of a large two storey cottage. A field of barley lies to the North. A path leads around the side of the cottage to the southwest.    

The small black cat from the farm path is here, washing himself among the barley.

You feel a cool breeze.

The cat meows.

>x cat
A small black cat with wide, yellow eyes. The cat is wearing a silver collar.

>x collor
You can't see any such thing.

>x collar
The cats name is Wellington.

>l
Front Of The Cottage
You stand in front of a large two storey cottage. A field of barley lies to the North. A path leads around the side of the cottage to the southwest.    

The small black cat from the farm path is here, washing himself among the barley.

You hear the harsh "caw" of a crow.

* * *

>s
Front Of The Cottage
You approach the front of a large two storey cottage that is very familiar to you. A field of barley lies to the North. A path leads around the side of the cottage to the southwest. The cottage itself is directly south, the entrance blocked by a heavy oak door.   

The small black cat from the farm path is here, washing himself among the barley.

The cat meows.

>touch cat
The cat seems more comfortable around you now.

The cat heads southeast to back of the cottage.

>n
The Barley Field
You are standing in a field of barley. To the north is a wooden gate leading to a farm path. A cottage lies to the south.

An old rotting wooden post is here. Propped up against the post, standing to attention, is a lone scarecrow.

You can also see The cat here.

>x cat
A small black cat with wide, yellow eyes. The cat is wearing a silver collar.

The cat begins scratching in the undergrowth.

The cat heads south to Front Of The Cottage.

* * *

>touch cat
The cat seems more comfortable around you now.

The cat heads southeast to back of the cottage.

>se
You follow garden path to the back of the cottage.

Back of the Cottage
You arrive in an ample-sized clearing of trampled barley which serves as a yard for the cottage. The fields continue off into the distance in all directions.  

On the perimeter of the clearing is an old, broken turnwrest plough.

You can see the cat here.

>x plough
In addition to the rust and general disrepair of the plough, the cumbersome plough also appears to have been damaged - the blades and handles are bent at awkward angles rendering the plough useless.

Hanging from the plough, you see a rusty key.

>get key
As you pick up the key, your heart jolts - you hear four loud bangs coming from the front of the cottage, like metal knocking on wood. The sound echoes around the hills and then all is silent again.

The cat begins scratching in the undergrowth.

>ne
You follow the garden path around to the front of the cottage.

Front Of The Cottage
You stand in front of a large two storey cottage . A field of barley lies to the North. A path leads around the side of the cottage to the southwest. The cottage itself is directly south, the entrance blocked by a heavy oak door. 

As you make your way around the front of the cottage, you survey the area to see if you can identify the cause of the banging. Just as you are about to resign to having imagined the sound, you observe to your horror that the field to the north is now empty. The scarecrow has left his post.. You can vaguely make out that something has been nailed to the post in place of the scarecrow, flapping gently in the breeze.

>unlock door
(with the rusty key)
You unlock the Front Door.

You hear the harsh "caw" of a crow.

The cat arrives from the southeast.

>open door
You open the Front Door.

You feel a cool breeze.

The cat heads north to the barley field.

>s
The Lobby
 As you enter the cottage through the heavy oak door, you disturb a murder of crows who were sheltering inside. A violent fury of black feathers whip past your face as the crows exit the cottage to join their brothers in the fields. 

The lobby itself is bare and largely unfurnished, with wooden floorboards that continue south into a food preparation area, and west into a large living room. A few shelves adorn the wall and a table sits against the western wall. You feel nauseous and short of breath. Surfaces feel cold and damp to the touch. 

You can see a shelf (on which is a clock) here.

>w
    *** End of demo! ***

In that game you scored 0 out of a possible 0, in 12 turns.

Would you like to RESTART, RESTORE a saved game, QUIT or UNDO the last command?

Please give one of the answers above.

Would you like to RESTART, RESTORE a saved game, QUIT or UNDO the last command?

* * *

>s
Front Of The Cottage
You approach the front of a large two storey cottage that is very familiar to you. A field of barley lies to the North. A path leads around the side of the cottage to the southwest. The cottage itself is directly south, the entrance blocked by a heavy oak door.   

The small black cat from the farm path is here, washing himself among the barley.

The cat meows.

>stroke cat
The cat seems more comfortable around you now.

the cat begins scratching in the undergrowth.

>z
Time passes.

You hear the harsh "caw" of a crow.

He heads north to The Barley Field.

>z
Time passes.

the cat arrives from the north.

>z
Time passes.

>z
Time passes.

the cat meows.

>l
Front Of The Cottage
You stand in front of a large two storey cottage. A field of barley lies to the North. A path leads around the side of the cottage to the southwest.    

You can see the cat here.

He heads north to The Barley Field.

* * *

>touch cat
As you approach the cat, it flees into the undergrowth.

I beg your pardon?

>s
(first opening the wooden gate)

The Barley Field
As you enter the barley field, your mind drifts to the fields of battle in the aftermath of Waterloo. The casualties were horrendous, the victory far from glorious. Many of the soldiers who died that day, the "scum of the earth" as Wellington had described them, had been recruited from villages and hamlets nearby. Wellington had later claimed  that it was "really wonderful that we should have made these men into the fine fellows they are." You consider the barrenness of that sentiment now that tens of thousands of those fine fellows are dead. Many of those who survived were not the same people they once were, with some succumbing to war exhaustion and others to madness or worse.

And what of yourself? Are you a soldier or a farm-hand? Is a return to your old life a possibility or is something within your very soul broken beyond repair? What does a soldier do when there is nothing left to fight for?

The chill wind is making it hard to breathe, and you begin to feel light headed. Further south through the fields you can see the old farm cottage. 

An old rotting wooden post is here. Propped up against the post, standing to attention, is a lone scarecrow.

>s
Front Of The Cottage
You approach the front of a large two storey cottage. A field of barley lies to the North. A path leads around the side of the cottage to the southwest. 

You feel unseen eyes watching you.    

The small black cat from the farm path is here, washing himself among the barley.

* * *

>x cat
The cat seems more comfortable around you now.

You hear the harsh "caw" of a crow.

>l
Front Of The Cottage
You stand in front of a large two storey cottage. A field of barley lies to the North. A path leads around the side of the cottage to the southwest.     

You can see a cat here.

The cat meows.

* * *

>punch cat
As you approach the cat, it flees into the undergrowth.

>s
(first opening the wooden gate)

The Barley Field
As you enter the barley field, your mind drifts to the fields of battle in the aftermath of Waterloo. The casualties were horrendous, the victory far from glorious. Many of the soldiers who died that day, the "scum of the earth" as Wellington had described them, had been recruited from villages and hamlets nearby. Wellington had later claimed  that it was "really wonderful that we should have made these men into the fine fellows they are." You consider the barrenness of that sentiment now that tens of thousands of those fine fellows are dead. Many of those who survived were not the same people they once were, with some succumbing to war exhaustion and others to madness or worse.

And what of yourself? Are you a soldier or a farm-hand? Is a return to your old life a possibility or is something within your very soul broken beyond repair? What does a soldier do when there is nothing left to fight for?

The chill wind is making it hard to breathe, and you begin to feel light headed. Further south through the fields you can see the old farm cottage. 

The small black cat from earlier emerges from the barley fields and sniffs the air.

An old rotting wooden post is here. Propped up against the post, standing to attention, is a lone scarecrow.

>l
The Barley Field
You are standing in a field of barley. To the north is a wooden gate leading to a farm path. A cottage lies to the south.

The small black cat is here.

An old rotting wooden post is here. Propped up against the post, standing to attention, is a lone scarecrow.

>n
The Farm Path
A wooden gate to the south leads to a field of barley. 

You hear the harsh "caw" of a crow.

>s
The Barley Field
You are standing in a field of barley. To the north is a wooden gate leading to a farm path. A cottage lies to the south.

The small black cat is here.

An old rotting wooden post is here. Propped up against the post, standing to attention, is a lone scarecrow.

* * *

>touch cat
As you approach the cat, it flees into the undergrowth.

>s
(first opening the wooden gate)

The Barley Field
As you enter the barley field, your mind drifts to the fields of battle in the aftermath of Waterloo. The casualties were horrendous, the victory far from glorious. Many of the soldiers who died that day, the "scum of the earth" as Wellington had described them, had been recruited from villages and hamlets nearby. Wellington had later claimed  that it was "really wonderful that we should have made these men into the fine fellows they are." You consider the barrenness of that sentiment now that tens of thousands of those fine fellows are dead. Many of those who survived were not the same people they once were, with some succumbing to war exhaustion and others to madness or worse.

And what of yourself? Are you a soldier or a farm-hand? Is a return to your old life a possibility or is something within your very soul broken beyond repair? What does a soldier do when there is nothing left to fight for? The chill wind is making it hard to breathe, and you begin to feel light headed. Further south through the fields you can see the old farm cottage. 

An old rotting wooden post is here. Propped up against the post, standing to attention, is a lone scarecrow.

>s
Front Of The Cottage
You approach the front of a large two storey cottage. A field of barley lies to the North. A path leads around the side of the cottage to the southwest.    

The small black cat from the farm path is here, washing himself among the barley.

>touch cat
The cat seems more comfortable around you now.

The cat meows.

>l
Front Of The Cottage
You stand in front of a large two storey cottage. A field of barley lies to the North. A path leads around the side of the cottage to the southwest.    

You can see a cat here.

The cat begins scratching in the undergrowth.

>x cat
A small black cat with wide, yellow eyes. The cat is wearing a silver collar.

You hear the harsh "caw" of a crow.

>x collar
The cats name is Wellington.

>l
Front Of The Cottage
You stand in front of a large two storey cottage. A field of barley lies to the North. A path leads around the side of the cottage to the southwest.    

You can see Wellington the cat here.

* * *

>z
Time passes.

Aww what an epic cat.He is epic.

>z
Time passes.

You hear the harsh "caw" of a crow.

* * *

>z
Time passes.

>stroke cat
As you approach the cat, it flees into the undergrowth.

>s
(first opening the wooden gate)

The Barley Field
As you enter the barley field, your mind drifts to the fields of battle in the aftermath of Waterloo. The casualties were horrendous, the victory far from glorious. Many of the soldiers who died that day, the "scum of the earth" as Wellington had described them, had been recruited from villages and hamlets nearby. Wellington had later claimed  that it was "really wonderful that we should have made these men into the fine fellows they are." You consider the barrenness of that sentiment now that tens of thousands of those fine fellows are dead. Many of those who survived were not the same people they once were, with some succumbing to war exhaustion and others to madness or worse.

And what of yourself? Are you a soldier or a farm-hand? Is a return to your old life a possibility or is something within your very soul broken beyond repair? What does a soldier do when there is nothing left to fight for? The chill wind is making it hard to breathe, and you begin to feel light headed. Further south through the fields you can see the old farm cottage. 

An old rotting wooden post is here. Propped up against the post, standing to attention, is a lone scarecrow.

>s
Front Of The Cottage
You approach the front of a large two storey cottage. A field of barley lies to the North. A path leads around the side of the cottage to the southwest.    

The small black cat from the farm path is here, washing himself among the barley.

The cat meows.

>stroke cat
The cat seems more comfortable around you now.

The cat heads to The Barley Field.

>n
The Barley Field
You are standing in a field of barley. To the north is a wooden gate leading to a farm path. A cottage lies to the south.

An old rotting wooden post is here. Propped up against the post, standing to attention, is a lone scarecrow.

You can also see a cat here.

You hear the harsh "caw" of a crow.

The cat heads to Front Of The Cottage.

* * *

>z
Time passes.

The cat meows.

>z
Time passes.

You feel a cool breeze.

* * *

>stroke cat
As you approach the cat, it flees into the undergrowth.

* * *

>s
Front Of The Cottage
You approach the front of a large two storey cottage that is very familiar to you. A field of barley lies to the North. A path leads around the side of the cottage to the southwest. The cottage itself is directly south, the entrance blocked by a heavy oak door.   

The small black cat from the farm path is here, washing himself among the barley.

You hear the harsh "caw" of a crow.

>stroke cat
The cat seems more comfortable around you now.

>z
Time passes.

The cat heads southeast to back of the cottage.

>z
Time passes.

>z
Time passes.

You feel a cool breeze.

>z
Time passes.

>se
You follow garden path to the back of the cottage.

Back of the Cottage
You are standing behind the cottage.

There is an old plough here.

You can also see the cat here.

>z
Time passes.

the cat heads northwest to Front Of The Cottage.

>nw
You follow the garden path around to the front of the cottage.

Front Of The Cottage
You stand in front of a large two storey cottage. A field of barley lies to the North. A path leads around the side of the cottage to the southwest.    

You can see the cat here.

You hear the harsh "caw" of a crow.

the cat heads southeast to Back of the Cottage.

>z
Time passes.

>z
Time passes.

the cat arrives from the southeast.

>z
Time passes.

* * *

>z
Time passes.

The cat heads southeast to back of the cottage.

>se
You follow garden path to the back of the cottage.

Back of the Cottage
You are standing behind the cottage.

There is an old plough here.

You can also see the cat here.

The cat heads northwest to front of the cottage.

>nw
You follow the garden path around to the front of the cottage.

Front Of The Cottage
You stand in front of a large two storey cottage . A field of barley lies to the North. A path leads around the side of the cottage to the southwest. The cottage itself is directly south, the entrance blocked by a heavy oak door.   

You can see the cat here.

>x cat
A small black cat with wide, yellow eyes. The cat is wearing a silver collar.

The cat heads southeast to back of the cottage.

>se
You follow garden path to the back of the cottage.

Back of the Cottage
You are standing behind the cottage.

There is an old plough here.

You can also see the cat here.

>x collar
The cats name is Wellington.

>look
Back of the Cottage
You are standing behind the cottage.

There is an old plough here.

You can also see Wellington here.

Wellington heads northwest to front of the cottage.

>x plough
It is an old plough.

resting on the plough, you see a rusty key.

>l
Back of the Cottage
You are standing behind the cottage.

There is an old plough here.

On the plough is a rusty key.

>get key
As you pick up the key, you hear four loud bangs coming from the front of the cottage.

>ne
You follow the garden path around to the front of the cottage.

Front Of The Cottage
You stand in front of a large two storey cottage . A field of barley lies to the North. A path leads around the side of the cottage to the southwest. The cottage itself is directly south, the entrance blocked by a heavy oak door. As you make your way around the front of the cottage, you survey the area to see if you can identify the cause of the banging. Just as you are about to resign to having imagined the sound, you observe to your horror that the field to the north is now empty. The scarecrow has left his post. It looks as if he's left something behind though... something is nailed to the post, flapping gently in the breeze.  

You can see Wellington here.

You feel a cool breeze.

* * *

>stroke cat
The cat seems more comfortable around you now.

>se
You follow garden path to the back of the cottage.

Back of the Cottage
You are standing behind the cottage.

There is an old plough here.

You can also see a cat here.

The cat begins scratching in the undergrowth.

The cat heads the northwest to Front Of The Cottage.

* * *

>stroke cat
The cat seems more comfortable around you now.

>n
The Barley Field
You are standing in a field of barley. To the north is a wooden gate leading to a farm path. A cottage lies to the south.

An old rotting wooden post is here. Propped up against the post, standing to attention, is a lone scarecrow.

You can also see a The cat here.

The cat heads south to Front Of The Cottage.

>s
Front Of The Cottage
You stand in front of a large two storey cottage. A field of barley lies to the North. A path leads around the side of the cottage to the southwest.    

You can see a The cat here.

You hear the harsh "caw" of a crow.

The cat heads southeast to Back of the Cottage.

>z
Time passes.

The cat arrives from southeast (Back of the Cottage).

>x cat
A small black cat with wide, yellow eyes. The cat is wearing a silver collar.

You feel a cool breeze.

The cat heads north to The Barley Field.

>z
Time passes.

The cat arrives from north (The Barley Field).

>x collar
The cats name is Wellington.

The cat meows.

Wellington the cat heads north to The Barley Field.

>z
Time passes.

Wellington the cat arrives from north (The Barley Field).

>x wellington
You can't see any such thing.

* * *

>s
Front Of The Cottage
You approach the front of a large two storey cottage that is very familiar to you. A field of barley lies to the North. A path leads around the side of the cottage to the southwest. The cottage itself is directly south, the entrance blocked by a heavy oak door.   

The small black cat from the farm path is here, washing himself among the barley.

You hear the harsh "caw" of a crow.

>z
Time passes.

the cat begins scratching in the undergrowth.

>z
Time passes.

>stroke cat
The cat seems more comfortable around you now.

the cat heads north to The Barley Field.

>z
Time passes.

* * *

>z
Time passes.

the cat arrives from the north.

>z
Time passes.

the cat heads southeast to Back of the Cottage.

>z
Time passes.

* * *

>z
Time passes.

the cat arrives from the southeast.

>z
Time passes.

the cat heads north to The Barley Field.

>z
Time passes.

You hear the harsh "caw" of a crow.

* * *

>z
Time passes.

>z
Time passes.

You feel a cool breeze.

the cat arrives from the north.

>z
Time passes.

the cat meows.

* * *

>s
Front Of The Cottage
You approach the front of a large two storey cottage. A field of barley lies to the North. A path leads around the side of the cottage to the southwest.    

The small black cat from the farm path is here, washing himself among the barley.

>stroke cat
The cat seems more comfortable around you now.

The cat meows.

The cat heads southeast to Back of the Cottage.

>se
You follow garden path to the back of the cottage.

Back of the Cottage
You are standing behind the cottage.

There is an old plough here.

You can also see a cat here.

The cat heads northwest to Front Of The Cottage.

>nw
You follow the garden path around to the front of the cottage.

Front Of The Cottage
You stand in front of a large two storey cottage. A field of barley lies to the North. A path leads around the side of the cottage to the southwest.    

You can see a cat here.

The cat begins scratching in the undergrowth.

The cat heads north to The Barley Field.

>n
The Barley Field
You are standing in a field of barley. To the north is a wooden gate leading to a farm path. A cottage lies to the south.

An old rotting wooden post is here. Propped up against the post, standing to attention, is a lone scarecrow.

You can also see a cat here.

The cat heads south to Front Of The Cottage.

* * *

>s
(first opening the wooden gate)

The Barley Field
As you enter the barley field, your mind drifts to the fields of battle in the aftermath of Waterloo. The casualties were horrendous, the victory far from glorious. Many of the soldiers who died that day, the "scum of the earth" as Wellington had described them, had been recruited from villages and hamlets nearby. Wellington had later claimed  that it was "really wonderful that we should have made these men into the fine fellows they are." You consider the barrenness of that sentiment now that tens of thousands of those fine fellows are dead. Many of those who survived were not the same people they once were, with some succumbing to war exhaustion and others to madness or worse.

And what of yourself? Are you a soldier or a farm-hand? Is a return to your old life a possibility or is something within your very soul broken beyond repair? What does a soldier do when there is nothing left to fight for? The chill wind is making it hard to breathe, and you begin to feel light headed. Further south through the fields you can see the old farm cottage. 

An old rotting wooden post is here. Propped up against the post, standing to attention, is a lone scarecrow.

>s
Front Of The Cottage
You approach the front of a large two storey cottage. A field of barley lies to the North. A path leads around the side of the cottage to the southwest.

>n
The Barley Field
You are standing in a field of barley. To the north is a wooden gate leading to a farm path. A cottage lies to the south.

An old rotting wooden post is here. Propped up against the post, standing to attention, is a lone scarecrow.

You hear the harsh "caw" of a crow.

>n
The Farm Path
A wooden gate to the south leads to a field of barley. 

You see a small black cat sheltering under some nearby foliage.

* * *

>s
Front Of The Cottage
You stand in front of a large two storey cottage. A field of barley lies to the North. A path leads around the side of the cottage to the southwest.    

The small black cat from the farm path is here, washing himself among the barley.

The cat meows.

>stroke cat
The cat seems more comfortable around you now.

cat heads southeast to Back of the Cottage.

>se
You follow garden path to the back of the cottage.

Back of the Cottage
You are standing behind the cottage.

There is an old plough here.

You can also see a cat here.

The cat begins scratching in the undergrowth.

cat heads northwest to Front Of The Cottage.

>ne
You follow the garden path around to the front of the cottage.

Front Of The Cottage
You stand in front of a large two storey cottage. A field of barley lies to the North. A path leads around the side of the cottage to the southwest.    

You can see a cat here.

cat heads north to The Barley Field.

* * *

>x wellington
The cat stares at you with wide yellow eyes which convey both curiosity and caution in equal measures.

You hear the harsh "caw" of a crow.

The cat meows.

* * *

>x undergrowth
Deep green foliage serves as a natural barrier separating the fields.

You hear the harsh "caw" of a crow.

* * *

>sit down
I didn't understand that sentence.

>attack cat
As you approach the cat, it flees into the undergrowth.

>s
(first opening the wooden gate)

The Barley Field
As you enter the barley field, your mind drifts to the fields of battle in the aftermath of Waterloo. The casualties were horrendous, the victory far from glorious. Many of the soldiers who died that day, the "scum of the earth" as Wellington had described them, had been recruited from villages and hamlets nearby. Wellington had later claimed  that it was "really wonderful that we should have made these men into the fine fellows they are." You consider the barrenness of that sentiment now that tens of thousands of those fine fellows are dead. Many of those who survived were not the same people they once were, with some succumbing to war exhaustion and others to madness or worse.

And what of yourself? Are you a soldier or a farm-hand? Is a return to your old life a possibility or is something within your very soul broken beyond repair? What does a soldier do when there is nothing left to fight for? The chill wind is making it hard to breathe, and you begin to feel light headed. Further south through the fields you can see the old farm cottage. 

An old rotting wooden post is here. Propped up against the post, standing to attention, is a lone scarecrow.

* * *

>s
Front Of The Cottage
You approach the front of a large two storey cottage. A field of barley lies to the North. A path leads around the side of the cottage to the southwest.    

The small black cat from the farm path is here, washing himself among the barley.

The cat meows.

>pet cat
The cat seems more comfortable around you now.

The cat begins scratching in the undergrowth.

The cat heads southeast to Back of the Cottage.

>se
You follow garden path to the back of the cottage.

Back of the Cottage
You are standing behind the cottage.

There is an old plough here.

You can also see a The cat here.

The cat heads northwest to Front Of The Cottage.

>se
You can't go that way.

The cat arrives from the northwest.

>x cat
A small black cat with wide, yellow eyes. The cat is wearing a silver collar.

The cat heads northwest to Front Of The Cottage.

>nw
You follow the garden path around to the front of the cottage.

Front Of The Cottage
You stand in front of a large two storey cottage. A field of barley lies to the North. A path leads around the side of the cottage to the southwest.    

You can see a The cat here.

The cat meows.

The cat heads north to The Barley Field.

>n
The Barley Field
You are standing in a field of barley. To the north is a wooden gate leading to a farm path. A cottage lies to the south.

An old rotting wooden post is here. Propped up against the post, standing to attention, is a lone scarecrow.

You can also see a The cat here.

The cat heads south to Front Of The Cottage.

>z
Time passes.

The cat arrives from the south.

>x collar
The cats name is Wellington.

Wellington the cat heads south to Front Of The Cottage.

>s
Front Of The Cottage
You stand in front of a large two storey cottage. A field of barley lies to the North. A path leads around the side of the cottage to the southwest.    

You can see Wellington the cat here.

Wellington the cat begins scratching in the undergrowth.

Wellington the cat heads southeast to Back of the Cottage.

* * *

I beg your pardon?

>stroke cat
As you approach the cat, it flees into the undergrowth.

>s
(first opening the wooden gate)

The Barley Field
As you enter the barley field, your mind drifts to the fields of battle in the aftermath of Waterloo. The casualties were horrendous, the victory far from glorious. Many of the soldiers who died that day, the "scum of the earth" as Wellington had described them, had been recruited from villages and hamlets nearby. Wellington had later claimed  that it was "really wonderful that we should have made these men into the fine fellows they are." You consider the barrenness of that statement  now that tens of thousands of those fine fellows were dead. Many of those who survived were not the same as they were before the war, having succumbed to war exhaustion or madness, or worse.

The chill wind is making it hard to breathe, and you begin to feel light headed. Further south through the fields you can see the old farm cottage. 

An old rotting wooden post is here. Propped up against the post, standing to attention, is a lone scarecrow.

You hear the harsh "caw" of a crow.

>s
Front Of The Cottage
You approach the front of a large two storey cottage that is very familiar to you. A field of barley lies to the North. A path leads around the side of the cottage to the southwest. The cottage itself is directly south, the entrance blocked by a heavy oak door.   

The small black cat from the farm path is here, washing himself among the barley.

You feel a cool breeze.

>stroke cat
The cat seems more comfortable around you now.

* * *

>z
Time passes.

The cat heads southeast to back of the cottage.

>se
You follow garden path to the back of the cottage.

Back of the Cottage
You are standing behind the cottage.

There is an old plough here.

You can also see the cat here.

The cat meows.

>nw
You follow the garden path around to the front of the cottage.

Front Of The Cottage
You stand in front of a large two storey cottage . A field of barley lies to the North. A path leads around the side of the cottage to the southwest. The cottage itself is directly south, the entrance blocked by a heavy oak door.   

You hear the harsh "caw" of a crow.

>x cat
You can't see any such thing.

>se
You follow garden path to the back of the cottage.

Back of the Cottage
You are standing behind the cottage.

There is an old plough here.

You can also see the cat here.

The cat heads northwest to front of the cottage.

>x collar
You can't see any such thing.

>look
Back of the Cottage
You are standing behind the cottage.

There is an old plough here.

>x plough
It is an old plough.

resting on the plough, you see a rusty key.

>l
Back of the Cottage
You are standing behind the cottage.

There is an old plough here.

On the plough is a rusty key.

The cat arrives from the northwest.

>get key
As you pick up the key, your heart jolts - you hear four loud bangs coming from the front of the cottage, like metal knocking on wood. The sound echoes around the hills and then all is silent again.

The cat begins scratching in the undergrowth.

>ne
You follow the garden path around to the front of the cottage.

Front Of The Cottage
You stand in front of a large two storey cottage . A field of barley lies to the North. A path leads around the side of the cottage to the southwest. The cottage itself is directly south, the entrance blocked by a heavy oak door. 

As you make your way around the front of the cottage, you survey the area to see if you can identify the cause of the banging. Just as you are about to resign to having imagined the sound, you observe to your horror that the field to the north is now empty. The scarecrow has left his post. It looks as if he's left something behind though... something is nailed to the post, flapping gently in the breeze.

>n
The Barley Field
You are standing in a field of barley. To the north is a wooden gate leading to a farm path. A cottage lies to the south.

An old rotting wooden post is here. 

On the post is a note.

* * *

>x note
There is a message inscribed onto the note in what looks like charcoal. The author has used aggressive straight lines to etch out each letter. The message reads:

"Your place is in the fields"

I beg your pardon?

>s
Front Of The Cottage
You stand in front of a large two storey cottage . A field of barley lies to the North. A path leads around the side of the cottage to the southwest. The cottage itself is directly south, the entrance blocked by a heavy oak door. 

In the field to the north you can see something nailed to a post.  You see a strange figure at the window 

You can see the cat here.

The cat heads southeast to back of the cottage.

>x figure
You see a strange figure at the window.

As your eyes begin to focus more clearly, the figure fades from view. Was it even there in the first place?

>open door
You heave with all of your might but the heavy oak door will not budge.

It seems to be locked.

>unlock door with key
You unlock the Front Door.

The cat arrives from the southeast.

* * *

The Scarecrow
An exploration of war and belonging by Mikey Hogarth The story genre is "Horror"
Release 1 / Serial number 130916 / Inform 7 build 6G60 (I6/v6.32 lib 6/12N) SD

The Farm Path
You are standing on a muddy farm path. A wooden gate to the south leads into a large barley field which forms part of a patchwork vista of yellow and brown draped over the distant landscape. The fields are separated by deep green foliage. 

Your journey here has been long and tiring. Beyond the field to the south you can see a thatched-roof cottage, a place you had once felt a connection with. A place you had once called home. In spite of your aching feet, the cottage no longer feels like an inviting respite. 

The weather is overcast and a gentle rain is falling. 

You can see an A small black cat is sheltering under a bush beside the path.
 here.

>x ca
You can't see any such thing.

>x cat
The cat stares at you with wide yellow eyes which convey both curiosity and caution in equal measures.

* * *

>stroke cat
As you approach the cat, it flees into the undergrowth.

>s
(first opening the wooden gate)

The Barley Field
As you enter the barley field, your mind drifts to the fields of battle in the aftermath of Waterloo. The casualties were horrendous, the victory far from glorious. Many of the soldiers who died that day, the "scum of the earth" as Wellington had described them, had been recruited from villages and hamlets nearby. Wellington had later claimed  that it was "really wonderful that we should have made these men into the fine fellows they are." You consider the barrenness of that sentiment now that tens of thousands of those fine fellows are dead. Many of those who survived were not the same people they once were, with some succumbing to war exhaustion and others to madness or worse.

And what of yourself? Are you a soldier or a farm-hand? Is a return to your old life a possibility or is something within your very soul broken beyond repair? What does a soldier do when there is nothing left to fight for?

The chill wind is making it hard to breathe, and you begin to feel light headed. Further south through the fields you can see the old farm cottage. 

A small black cat is sheltering under a bush beside the path.

An old rotting wooden post is here. Propped up against the post, standing to attention, is a lone scarecrow.

* * *

>s
(first opening the wooden gate)

The Barley Field
As you enter the barley field, your mind drifts to the fields of battle in the aftermath of Waterloo. The casualties were horrendous, the victory far from glorious. Many of the soldiers who died that day, the "scum of the earth" as Wellington had described them, had been recruited from villages and hamlets nearby. Wellington had later claimed  that it was "really wonderful that we should have made these men into the fine fellows they are." You consider the barrenness of that sentiment now that tens of thousands of those fine fellows are dead. Many of those who survived were not the same people they once were, with some succumbing to war exhaustion and others to madness or worse.

And what of yourself? Are you a soldier or a farm-hand? Is a return to your old life a possibility or is something within your very soul broken beyond repair? What does a soldier do when there is nothing left to fight for?

The chill wind is making it hard to breathe, and you begin to feel light headed. Further south through the fields you can see the old farm cottage. 

An old rotting wooden post is here. Propped up against the post, standing to attention, is a lone scarecrow.

* * *

The Scarecrow
An exploration of war and belonging by Mikey Hogarth The story genre is "Horror"
Release 1 / Serial number 130918 / Inform 7 build 6G60 (I6/v6.32 lib 6/12N) SD

The Farm Path
You are standing on a muddy farm path. A wooden gate to the south leads into a large barley field which forms part of a patchwork vista of yellow and brown draped over the distant landscape. The fields are separated by deep green foliage. 

Your journey here has been long and tiring. Beyond the field to the south you can see a thatched-roof cottage, a place you had once felt a connection with. A place you had once called home. In spite of your aching feet, the cottage no longer feels like an inviting respite. 

The weather is overcast and a gentle rain is falling.  

You see a small black cat sheltering under some nearby foliage.

* * *

The Scarecrow
An exploration of war and belonging by Mikey Hogarth The story genre is "Horror"
Release 1 / Serial number 130917 / Inform 7 build 6G60 (I6/v6.32 lib 6/12N) SD

The Farm Path
You are standing on a muddy farm path. A wooden gate to the south leads into a large barley field which forms part of a patchwork vista of yellow and brown draped over the distant landscape. The fields are separated by deep green foliage. 

Your journey here has been long and tiring. Beyond the field to the south you can see a thatched-roof cottage, a place you had once felt a connection with. A place you had once called home. In spite of your aching feet, the cottage no longer feels like an inviting respite. 

The weather is overcast and a gentle rain is falling.  

You see a small black cat sheltering under some nearby foliage.

>look north
You see nothing in that direction.

You hear the harsh "caw" of a crow.

>look up
Dull, grey clouds hang overhead.

* * *

>x cat
The cat stares at you with wide yellow eyes which convey both curiosity and caution in equal measures.

>touch cat
As you approach the cat, it flees into the undergrowth.

>s
(first opening the wooden gate)

The Barley Field
As you enter the barley field, your mind drifts to the fields of battle in the aftermath of Waterloo. The casualties were horrendous, the victory far from glorious. Many of the soldiers who died that day, the "scum of the earth" as Wellington had described them, had been recruited from villages and hamlets nearby. Wellington had later claimed  that it was "really wonderful that we should have made these men into the fine fellows they are." You consider the barrenness of that sentiment now that tens of thousands of those fine fellows are dead. Many of those who survived were not the same people they once were, with some succumbing to war exhaustion and others to madness or worse.

And what of yourself? Are you a soldier or a farm-hand? Is a return to your old life a possibility or is something within your very soul broken beyond repair? What does a soldier do when there is nothing left to fight for?

The chill wind is making it hard to breathe, and you begin to feel light headed. Further south through the fields you can see the old farm cottage. 

An old rotting wooden post is here. Propped up against the post, standing to attention, is a lone scarecrow.

You hear the harsh "caw" of a crow.

>s
Front Of The Cottage
You approach the front of a large two storey cottage. A field of barley lies to the North. A path leads around the side of the cottage to the southwest.    

The small black cat from the farm path is here, washing himself among the barley.

>x cat
A small black cat with wide, yellow eyes.

>x collar
You see nothing special about the silver collar.

>touch cat
The cat seems more comfortable around you now.

>touch cat
The cat purrs loudly.

The cat meows.

>stroke cat
The cat rubs its face against your leg.

You feel a cool breeze.

>x cat
A small black cat with wide, yellow eyes.