Welcome to "The Scarecrow". If you have not experienced interactive fiction before, type "Help" at the prompt to get you started.

Please press SPACE to continue.

Everything is supposed to be very quiet after a massacre, and it always is, except for the birds. And what do the birds say? All there is to say about a massacre, things like "Poo-tee-weet". -- Kurt Vonnegut

Please press SPACE to continue.

In the winter of 1815, after countless millions had perished, the Napoleonic Wars came to an end. The little corporal Napoleon Bonaparte, emperor of France for the last decade, was exiled to the volcanic island of St Helena where he would see out the last six years of his life.

The end of the Napoleonic wars saw the start of a great agricultural depression in the United Kingdom that would last for a quarter of a century. Many farms succumbed to abandonment and disrepair as both landlords and tenants fell into bankruptcy.

It is in the wake of this ruin, far from the bloody fields of Waterloo and Rocquencourt, that you find yourself standing on a long farm road in Suffolk, surrounded by patchwork fields of oat, barley and wheat. The crops around you wreak of disease and neglect, and a dull lifelessness hangs in the air like the fog of war. All is silent, save for the cries of carrion crow circling above.

Five hundred miles away, a young author called Mary Shelley has just completed her first novel, "The Modern Prometheus"...

Please press SPACE to continue.

* * *

>remove scarecrow
(first taking the scarecrow)
I don't suppose the scarecrow would care for that.

>get scarecrow
I don't suppose the scarecrow would care for that.

* * *

>s
Front Of The Cottage
You approach the front of a large two storey cottage that is very familiar to you. A field of barley lies to the North. A path leads around the side of the cottage to the southwest. The cottage itself is directly south, the entrance blocked by a heavy oak door.  

You hear the harsh "caw" of a crow.

>n
The Barley Field
You are standing in a field of barley. To the north is a wooden gate leading to a farm path. A cottage lies to the south.

An old rotting wooden post is here. Propped up against the post, standing to attention, is a lone scarecrow.

>remove scarecrow
(first taking the scarecrow)
The scarecrow is fastened tightly to the post.

>take scarecrow
The scarecrow is fastened tightly to the post.

* * *

>s
Front Of The Cottage
You approach the front of a large two storey cottage that is very familiar to you. A field of barley lies to the North. A path leads around the side of the cottage to the southwest. The cottage itself is directly south, the entrance blocked by a heavy oak door.  

You hear the harsh "caw" of a crow.

>push door
It will not budge. It must be locked.

* * *

>s
Front Of The Cottage
You approach the front of a large two storey cottage that is very familiar to you. A field of barley lies to the North. A path leads around the side of the cottage to the southwest. The cottage itself is directly south, the entrance blocked by a heavy oak door.  

You hear the harsh "caw" of a crow.

>open door
You heave with all of your might but the heavy oak door will not budge.

You feel a cool breeze.

>push door
You heave with all of your might but the heavy oak door will not budge.

* * *

>s
Front Of The Cottage
You approach the front of a large two storey cottage that is very familiar to you. A field of barley lies to the North. A path leads around the side of the cottage to the southwest. The cottage itself is directly south, the entrance blocked by a heavy oak door.  

You hear the harsh "caw" of a crow.

>se
You follow garden path to the back of the cottage.

Back of the Cottage
You arrive in an ample-sized clearing of trampled barley which serves as a yard for the cottage.

You feel a slight twinge in your knee and wince in pain as you correct yourself. In that instant your thoughts turn to musket fire and the mayhem of battle, and to the sharp and sudden trauma below your right femur. 

And to falling.

You take a moment to gather your composure. You close your eyes and begin repeating to yourself "You are home. You are alive. This is real." Eventually you open your eyes and breathe in the cold country air.

On the perimeter of the clearing is an old, broken plough.

>x plough
In addition to the rust and general disrepair of the plough, the cumbersome plough also appears to have been damaged - the blades and handles are bent at awkward angles rendering the plough useless.

Hanging from the plough, you see a rusty key.

>get key
As you pick up the key, your heart jolts - you hear four loud bangs coming from the front of the cottage, like metal knocking on wood. The sound echoes around the hills and then all is silent again.

>ne
You follow the garden path around to the front of the cottage.

As you make your way around the front of the cottage, you survey the area to see if you can identify the cause of the banging. Just as you are about to resign to having imagined the sound, you observe to your horror that the field to the north is now empty. 

The scarecrow has left his post!

 You can vaguely make out that something has been nailed to the post in place of the scarecrow, flapping gently in the breeze.

Please press SPACE to continue.

Front Of The Cottage
You stand in front of a large two storey cottage . A field of barley lies to the North. A path leads around the side of the cottage to the southwest. The cottage itself is directly south, the entrance blocked by a heavy oak door. 

In the field to the north you can see something nailed to a post.

>n
The Barley Field
You are standing in a field of barley. To the north is a wooden gate leading to a farm path. A cottage lies to the south.

An old rotting wooden post is here. 

On the post is a note.

>x note
There is a message inscribed onto the note in what looks like charcoal. The author has used aggressive straight lines to etch out each letter. The message reads:

"Your place is in the fields"

>s
Front Of The Cottage
You stand in front of a large two storey cottage . A field of barley lies to the North. A path leads around the side of the cottage to the southwest. The cottage itself is directly south, the entrance blocked by a heavy oak door. 

In the field to the north you can see something nailed to a post. 

You see a strange figure at one of the cottage's upper windows. 

You feel a cool breeze.

* * *

Front Of The Cottage
You stand in front of a large two storey cottage . A field of barley lies to the North. A path leads around the side of the cottage to the southwest. The cottage itself is directly south, the entrance blocked by a heavy oak door. 

In the field to the north you can see something nailed to a post.

>s
(first opening the Front Door)
You heave with all of your might but the heavy oak door will not budge. It appears to be locked.

>n
The Barley Field
You are standing in a field of barley. To the north is a wooden gate leading to a farm path. A cottage lies to the south.

An old rotting wooden post is here. 

On the post is a note.

* * *

>x note
There is a message inscribed onto the note in what looks like charcoal. The author has used aggressive straight lines to etch out each letter. The message reads:

"Your place is in the fields"

>x coat
You can't see any such thing.

>n
The Farm Path
A wooden gate to the south leads to a field of barley. 

You see a small black cat sheltering under some nearby foliage.

>x undergrowth
Deep green foliage serves as a natural barrier separating the fields.

Something in the nearby undergrowth catches your eye - it appears to be a letter.

The cat tilts his head to one side.

>x letter
You start the letter:

   
General Hospital, Antwerp, 24th June 1815. After a long silence, I embrace the opportunity of informing you respecting my present situation. On the 15th, about 12 o'clock at night, we turned out and at two in the morning marched from the city of Brussels, to meet the enemy, who were advancing in great force on that city. About three o'clock in the afternoon of the 16th, we came up with them. Our whole force did not exceed 12,000 men, who were fatigued with a long march of upwards of 20 miles, encumbered with knapsacks and other luggage. The day was uncommonly warm, and no water to be had on the road; however, we were brought up, in order of battle. The French being strongly posted in a thick wood, to the number of 40,000 men, including cavalry and lancers, gave us very little time to look around us ere the fight commenced on both sides, in an awful and destructive manner, they having every advantage of us, both as to position and numbers, particularly in cavalry, as the British dragoons had not yet come up.

A scrawl at the bottom of the letter indicates that this is part 1 of 4.

The cat blinks slowly.

* * *

>x lpough
You can't see any such thing.

>x plough
In addition to the rust and general disrepair of the plough, the cumbersome plough also appears to have been damaged - the blades and handles are bent at awkward angles rendering the plough useless.

Hanging from the plough, you see a rusty key.

* * *

>ne
You follow the garden path around to the front of the cottage.

Front Of The Cottage
You stand in front of a large two storey cottage . A field of barley lies to the North. A path leads around the side of the cottage to the southwest. The cottage itself is directly south, the entrance blocked by a heavy oak door.  

You hear the harsh "caw" of a crow.

>x n
You see nothing unexpected in that direction.

>n
The Barley Field
You are standing in a field of barley. To the north is a wooden gate leading to a farm path. A cottage lies to the south.

An old rotting wooden post is here. Propped up against the post, standing to attention, is a lone scarecrow.

>n
The Farm Path
A wooden gate to the south leads to a field of barley. 

You see a small black cat sheltering under some nearby foliage.

The cat tilts his head to one side.

>stroke cat
As you approach the cat, it flees into the undergrowth.

You feel a cool breeze.

>x undergrowth
Deep green foliage serves as a natural barrier separating the fields.

Something in the nearby undergrowth catches your eye - it appears to be a letter.

>get letter
Taken.

>s
The Barley Field
You are standing in a field of barley. To the north is a wooden gate leading to a farm path. A cottage lies to the south.

An old rotting wooden post is here. Propped up against the post, standing to attention, is a lone scarecrow.

>x coat
A tattered red coat.

As you run your fingers along the hem of one of the sleeves, a folded piece of paper falls from one of the inside pockets. It appears to be a letter.

>get letter
(page two of a letter)
Taken.

>s
Front Of The Cottage
You stand in front of a large two storey cottage . A field of barley lies to the North. A path leads around the side of the cottage to the southwest. The cottage itself is directly south, the entrance blocked by a heavy oak door.  

The small black cat from the farm path is here, washing himself among the barley.

>x corn
Acres of barley, wheat and oat stretch over the horizon. The fields are wild and unkempt. Many of the crops have been ravaged by disease.

In amongst the crop here you see a folded piece of paper. It appears to be a letter.

The cat blinks slowly.

>get letter
(page three of a letter)
Taken.

The cat tilts his head to one side.

I beg your pardon?

>ne
The fields of corn seem to go on forever and there would be little point in entering them. The Barley Field is north. The Lobby is south. Back of the Cottage is southeast. 

You hear the harsh "caw" of a crow.

* * *

>enter field
The fields of corn seem to go on forever and there would be little point in entering them. Front Of The Cottage is northwest.

>nw
You follow the garden path around to the front of the cottage.

Front Of The Cottage
You stand in front of a large two storey cottage . A field of barley lies to the North. A path leads around the side of the cottage to the southwest. The cottage itself is directly south, the entrance blocked by a heavy oak door.

* * *

>s
Front Of The Cottage
You approach the front of a large two storey cottage that is very familiar to you. A field of barley lies to the North. A path leads around the side of the cottage to the southwest. The cottage itself is directly south, the entrance blocked by a heavy oak door.  

You hear the harsh "caw" of a crow.

>s
(first opening the Front Door)
You heave with all of your might but the heavy oak door will not budge. It appears to be locked.

>se
You follow garden path to the back of the cottage.

Back of the Cottage
You arrive in an ample-sized clearing of trampled barley which serves as a yard for the cottage. The fields continue off into the distance in all directions.  

On the perimeter of the clearing is an old, broken turnwrest plough.

>s
The fields of corn seem to go on forever and there would be little point in entering them. Front Of The Cottage is northwest.

>ne
You follow the garden path around to the front of the cottage.

Front Of The Cottage
You stand in front of a large two storey cottage . A field of barley lies to the North. A path leads around the side of the cottage to the southwest. The cottage itself is directly south, the entrance blocked by a heavy oak door.

>s
(first opening the Front Door)
You heave with all of your might but the heavy oak door will not budge. It appears to be locked.

>ne
The fields of corn seem to go on forever and there would be little point in entering them. The Barley Field is north. The Lobby is south. Back of the Cottage is southeast.

>n
The Barley Field
You are standing in a field of barley. To the north is a wooden gate leading to a farm path. A cottage lies to the south.

An old rotting wooden post is here. Propped up against the post, standing to attention, is a lone scarecrow.

>s
Front Of The Cottage
You stand in front of a large two storey cottage . A field of barley lies to the North. A path leads around the side of the cottage to the southwest. The cottage itself is directly south, the entrance blocked by a heavy oak door.

* * *

>se
You follow garden path to the back of the cottage.

Back of the Cottage
You arrive in an ample-sized clearing of trampled barley which serves as a yard for the cottage. The fields continue off into the distance in all directions.  

On the perimeter of the clearing is an old, broken turnwrest plough.

>se
The fields of corn seem to go on forever and there would be little point in entering them. Front Of The Cottage is northwest.

>ne
You follow the garden path around to the front of the cottage.

Front Of The Cottage
You stand in front of a large two storey cottage . A field of barley lies to the North. A path leads around the side of the cottage to the southwest. The cottage itself is directly south, the entrance blocked by a heavy oak door.

>n
The Barley Field
You are standing in a field of barley. To the north is a wooden gate leading to a farm path. A cottage lies to the south.

An old rotting wooden post is here. Propped up against the post, standing to attention, is a lone scarecrow.

* * *

>n
The Farm Path
A wooden gate to the south leads to a field of barley. 

You see a small black cat sheltering under some nearby foliage.

The cat tilts his head to one side.

>x corn
Acres of barley, wheat and oat stretch over the horizon. The fields are wild and unkempt. Many of the crops have been ravaged by disease.

In amongst the crop here you see a folded piece of paper. It appears to be a letter.

The cat blinks slowly.

>l
The Farm Path
A wooden gate to the south leads to a field of barley. 

You see a small black cat sheltering under some nearby foliage.

You can see page one of a letter here.

>s
The Barley Field
You are standing in a field of barley. To the north is a wooden gate leading to a farm path. A cottage lies to the south.

An old rotting wooden post is here. Propped up against the post, standing to attention, is a lone scarecrow.

>s
Front Of The Cottage
You stand in front of a large two storey cottage . A field of barley lies to the North. A path leads around the side of the cottage to the southwest. The cottage itself is directly south, the entrance blocked by a heavy oak door.

>x undergrowth
Deep green foliage serves as a natural barrier separating the fields.

Something in the nearby undergrowth catches your eye - it appears to be a letter.

>l
Front Of The Cottage
You stand in front of a large two storey cottage . A field of barley lies to the North. A path leads around the side of the cottage to the southwest. The cottage itself is directly south, the entrance blocked by a heavy oak door.  

You can see page two of a letter here.

* * *

>e
The fields of corn seem to go on forever and there would be little point in entering them. The Farm Path is north. Front Of The Cottage is south. 
You hear the harsh "caw" of a crow.

>w
The fields of corn seem to go on forever and there would be little point in entering them. The Farm Path is north. Front Of The Cottage is south. 
You feel a cool breeze.

>s
Front Of The Cottage
You approach the front of a large two storey cottage that is very familiar to you. A field of barley lies to the North. A path leads around the side of the cottage to the southwest. The cottage itself is directly south, the entrance blocked by a heavy oak door.

>e
The fields of corn seem to go on forever and there would be little point in entering them. The Barley Field is north. The Lobby is south. Back of the Cottage is southeast.

>w
The fields of corn seem to go on forever and there would be little point in entering them. The Barley Field is north. The Lobby is south. Back of the Cottage is southeast.

>sw
You follow garden path to the back of the cottage.

Back of the Cottage
You arrive in an ample-sized clearing of trampled barley which serves as a yard for the cottage. The fields continue off into the distance in all directions.  

On the perimeter of the clearing is an old, broken turnwrest plough.

>w
The fields of corn seem to go on forever and there would be little point in entering them. Front Of The Cottage is northwest.

I beg your pardon?

>enter corn
That's not something you can enter.

* * *

>e
The fields of corn seem to go on forever and there would be little point in entering them. The Farm Path is north. Front Of The Cottage is south. 
You hear the harsh "caw" of a crow.

>s
Front Of The Cottage
You approach the front of a large two storey cottage that is very familiar to you. A field of barley lies to the North. A path leads around the side of the cottage to the southwest. The cottage itself is directly south, the entrance blocked by a heavy oak door.

>ne
You can't go that way.

* * *

>m
That's not a verb I recognise.

>n
The Farm Path
A wooden gate to the south leads to a field of barley. 

You see a small black cat sheltering under some nearby foliage.

>pet cat
As you approach the cat, it flees into the undergrowth.

You hear the harsh "caw" of a crow.

>s
The Barley Field
You are standing in a field of barley. To the north is a wooden gate leading to a farm path. A cottage lies to the south.

An old rotting wooden post is here. Propped up against the post, standing to attention, is a lone scarecrow.

>s
Front Of The Cottage
You approach the front of a large two storey cottage that is very familiar to you. A field of barley lies to the North. A path leads around the side of the cottage to the southwest. The cottage itself is directly south, the entrance blocked by a heavy oak door.   

The small black cat from the farm path is here, washing himself among the barley.

>pet cat
The cat seems more comfortable around you now.

The cat heads southeast to back of the cottage.

>follow cat
You can't see any such thing.

* * *

>n
The Farm Path
A wooden gate to the south leads to a field of barley. 

You see a small black cat sheltering under some nearby foliage.

You hear the harsh "caw" of a crow.

The cat tilts his head to one side.

>pet cat
As you approach the cat, it flees into the undergrowth.

>s
The Barley Field
You are standing in a field of barley. To the north is a wooden gate leading to a farm path. A cottage lies to the south.

An old rotting wooden post is here. Propped up against the post, standing to attention, is a lone scarecrow.

You hear the harsh "caw" of a crow.

>s
Front Of The Cottage
You approach the front of a large two storey cottage that is very familiar to you. A field of barley lies to the North. A path leads around the side of the cottage to the southwest. The cottage itself is directly south, the entrance blocked by a heavy oak door.   

The small black cat from the farm path is here, washing himself among the barley.

>pet cat
The cat seems more comfortable around you now.

The cat heads north to the barley field.

>l
Front Of The Cottage
You stand in front of a large two storey cottage . A field of barley lies to the North. A path leads around the side of the cottage to the southwest. The cottage itself is directly south, the entrance blocked by a heavy oak door.   

The cat arrives from the north.

>l
Front Of The Cottage
You stand in front of a large two storey cottage . A field of barley lies to the North. A path leads around the side of the cottage to the southwest. The cottage itself is directly south, the entrance blocked by a heavy oak door.   

You can see the cat here.

The cat heads north to the barley field.

>follow cat
You can't see any such thing.

* * *

>n
The Farm Path
A wooden gate to the south leads to a field of barley. 

You see a small black cat sheltering under some nearby foliage.

You hear the harsh "caw" of a crow.

The cat tilts his head to one side.

>s
The Farm Path is north. Front Of The Cottage is south. 
The Barley Field
You are standing in a field of barley. To the north is a wooden gate leading to a farm path. A cottage lies to the south.

An old rotting wooden post is here. Propped up against the post, standing to attention, is a lone scarecrow.

>n
The Farm Path
A wooden gate to the south leads to a field of barley. 

You see a small black cat sheltering under some nearby foliage.

* * *

>n
The Farm Path
A wooden gate to the south leads to a field of barley. 

You see a small black cat sheltering under some nearby foliage.

You hear the harsh "caw" of a crow.

The cat tilts his head to one side.

>stroke cat
As you approach the cat, it flees into the undergrowth.

I beg your pardon?

>s
The Barley Field
You are standing in a field of barley. To the north is a wooden gate leading to a farm path. A cottage lies to the south.

An old rotting wooden post is here. Propped up against the post, standing to attention, is a lone scarecrow.

>s
Front Of The Cottage
You approach the front of a large two storey cottage that is very familiar to you. A field of barley lies to the North. A path leads around the side of the cottage to the southwest. The cottage itself is directly south, the entrance blocked by a heavy oak door.  

The small black cat from the farm path is here, washing himself among the barley.

The cat blinks slowly.

>x cat
A small black cat with wide, yellow eyes. The cat is wearing a silver collar.

>x collar
The cat edges away warily before you can get close enough.

You feel a cool breeze.

The cat tilts his head to one side.

* * *

>x cornfield
You can't see any such thing.

>x corn
Acres of barley, wheat and oat stretch over the horizon. The fields are wild and unkempt. Many of the crops have been ravaged by disease.

In amongst the crop here you see a folded piece of paper. It appears to be a letter.

>l
The Barley Field
You are standing in a field of barley. To the north is a wooden gate leading to a farm path. A cottage lies to the south.

An old rotting wooden post is here. Propped up against the post, standing to attention, is a lone scarecrow.

You can also see page one of a letter here.

* * *

>x field
Acres of barley, wheat and oat stretch over the horizon. The fields are wild and unkempt. Many of the crops have been ravaged by disease.

In amongst the crop here you see a folded piece of paper. It appears to be a letter.

>get letter
Taken.

>s
Front Of The Cottage
You approach the front of a large two storey cottage that is very familiar to you. A field of barley lies to the North. A path leads around the side of the cottage to the southwest. The cottage itself is directly south, the entrance blocked by a heavy oak door.

>x foliage
Deep green foliage serves as a natural barrier separating the fields.

Something in the nearby undergrowth catches your eye - it appears to be a letter.

>l
Front Of The Cottage
You stand in front of a large two storey cottage . A field of barley lies to the North. A path leads around the side of the cottage to the southwest. The cottage itself is directly south, the entrance blocked by a heavy oak door.  

You can see page two of a letter here.

* * *

The weather is overcast and a gentle rain is falling. The wind here is chill, and the crows are legion.

The Scarecrow
A short Napoleonic agricultural chiller by Mikey Hogarth The story genre is "Horror"
Release 1 / Serial number 130928 / Inform 7 build 6G60 (I6/v6.32 lib 6/12N) SD

The Farm Path
You are standing on a muddy farm path. A wooden gate to the south leads into a large barley field. Similar fields lead off into the distance, separated from one another by deep green foliage. 

Your journey here has been long and tiring. Beyond the field to the south you can see a thatched-roof cottage, a place you had once called home. In spite of your aching feet, the cottage no longer feels like an inviting respite .  

You see a small black cat sheltering under some nearby foliage.

>x undergrowth
Deep green foliage serves as a natural barrier separating the fields.

Something in the nearby undergrowth catches your eye - it appears to be a letter.

The cat tilts his head to one side.

>get all
page one of a letter: Taken.

>s
(first opening the wooden gate)

The Barley Field
As you enter the barley field, your mind drifts to the fields of battle in the aftermath of Waterloo. The casualties were horrendous, the victory far from glorious. Many of the soldiers who died that day, the "scum of the earth" as Wellington had described them, had been recruited from villages and hamlets nearby. Wellington had later reflected that it was "really wonderful that we should have made these men into the fine fellows they are." You consider the barrenness of that statement  now that tens of thousands of those fine fellows are dead. Many of those who survived were not the same as they were before the war, having succumbed to war exhaustion or madness, or worse.

The chill wind is making it hard to breathe, and you begin to feel light headed. Further south through the fields you can see the old farm cottage. 

An old rotting wooden post is here. Propped up against the post, standing to attention, is a lone scarecrow.

>x coat
A tattered red coat.

As you run your fingers along the hem of one of the sleeves, a folded piece of paper falls from one of the inside pockets. It appears to be a letter.

>l
The Barley Field
You are standing in a field of barley. To the north is a wooden gate leading to a farm path. A cottage lies to the south.

An old rotting wooden post is here. Propped up against the post, standing to attention, is a lone scarecrow.

You can also see page two of a letter here.

>get letter
(page two of a letter)
Taken.

>s
Front Of The Cottage
You approach the front of a large two storey cottage that is very familiar to you. A field of barley lies to the North. A path leads around the side of the cottage to the southwest. The cottage itself is directly south, the entrance blocked by a heavy oak door.

>x field
Acres of barley, wheat and oat stretch over the horizon. The fields are wild and unkempt. Many of the crops have been ravaged by disease.

In amongst the crop here you see a folded piece of paper. It appears to be a letter.

>get letter
(page three of a letter)
Taken.

You hear the harsh "caw" of a crow.

>se
You follow garden path to the back of the cottage.

Back of the Cottage
You arrive in an ample-sized clearing of trampled barley which serves as a yard for the cottage.

You feel a slight twinge in your knee and wince in pain as you correct yourself. In that instant your thoughts turn to musket fire and the mayhem of battle, and to the sharp and sudden trauma below your right femur. 

And to falling.

You take a moment to gather your composure. You close your eyes and begin repeating to yourself "You are home. You are alive. " Eventually you open your eyes and breathe in the cold country air.

On the perimeter of the clearing is an old, broken plough.

>x plough
In addition to the rust and general disrepair of the plough, it also appears to have been damaged - the blades and handles are bent at awkward angles rendering the plough useless. It is as though somebody has purposefully impaired the plough from usage.

Hanging from the plough, you see a rusty key.

>get key
As you pick up the key, your heart jolts - you hear four loud bangs coming from the front of the cottage, like metal knocking on wood. The sound echoes around the hills and then all is silent again.

* * *

Front Of The Cottage
You stand in front of a large two storey cottage . A field of barley lies to the North. A path leads around the side of the cottage to the southwest. The cottage itself is directly south, the entrance blocked by a heavy oak door. 

In the field to the north you can see something nailed to a post.

>unlock door
What do you want to unlock the Front Door with?

>key
You unlock the Front Door.

>s
(first opening the Front Door)

The Lobby
 As you enter the cottage through the heavy oak door, you disturb a murder of crows who were sheltering inside. A violent fury of black feathers whip past your face as the crows exit the cottage to join their brothers in the fields. 

The lobby itself is bare and largely unfurnished, with wooden floorboards that continue south into a food preparation area, and west into a large living room. A few shelves adorn the wall and a table sits against the western wall. You feel nauseous and short of breath. Surfaces feel cold and damp to the touch. 

You can see a shelf (on which is a clock) here.

>x table
A simple wooden table.

Tucked into the woodwork beneath the table, you find a folded piece of paper. It appears to be a letter.

>get letter
(page four of a letter)
Taken.

>read fourth page
You start the letter:

   
Thus I have given you as full an account of affairs, principally what I witnessed on the 16th, as I could; that relating to the 18th being from report. Nothing can exceed the kindness and attention of the inhabitants of this city to our wounded men : the hospital is constantly filled with ladies and gentlemen who, although speaking a different language, personally administer to our wants with the kindest attention, distributing clean shirts, bread, wine, coffee, tea, milk and fruit of all sorts with every requisite for our comfort and accommodation.

Faithfully yours,

The name signed at the foot of the letter is illegible.

* * *

>s
(first opening the wooden gate)

The Barley Field
As you enter the barley field, your mind drifts to the fields of battle in the aftermath of Waterloo. The casualties were horrendous, the victory far from glorious. Many of the soldiers who died that day, the "scum of the earth" as Wellington had described them, had been recruited from villages and hamlets nearby. Wellington had later reflected that it was "really wonderful that we should have made these men into the fine fellows they are." You consider the barrenness of that statement  now that tens of thousands of those fine fellows are dead. Many of those who survived were not the same as they were before the war, having succumbed to war exhaustion or madness, or worse.

The chill wind is making it hard to breathe, and you begin to feel light headed. Further south through the fields you can see the old farm cottage. 

An old rotting wooden post is here. Propped up against the post, standing to attention, is a lone scarecrow.

>s
Front Of The Cottage
You approach the front of a large two storey cottage that is very familiar to you. A field of barley lies to the North. A path leads around the side of the cottage to the southwest. The cottage itself is directly south, the entrance blocked by a heavy oak door.

>se
You follow garden path to the back of the cottage.

Back of the Cottage
You arrive in an ample-sized clearing of trampled barley which serves as a yard for the cottage.

You feel a slight twinge in your knee and wince in pain as you correct yourself. In that instant your thoughts turn to musket fire and the mayhem of battle, and to the sharp and sudden trauma below your right femur. 

And to falling.

You take a moment to gather your composure. You close your eyes and begin repeating to yourself "You are home. You are alive. " Eventually you open your eyes and breathe in the cold country air.

On the perimeter of the clearing is an old, broken plough. You can also see an ancient gnarled tree here.

>l
Back of the Cottage
You are standing at the rear of the cottage.

On the perimeter of the clearing is an old, broken plough. You can also see an ancient gnarled tree here.

>x tree
An old, gnarled tree. The tree is bereft of leaves and extends around twenty feet into the air with menacing, claw-like branches. The tree appears to have lost several branches, and is scarred with what you presume to be lightning damage.

As you run your fingers along the hem of one of the sleeves, a folded piece of paper falls from one of the inside pockets. It appears to be a letter.

* * *

>x plough
In addition to the rust and general disrepair of the plough, it also appears to have been damaged - the blades and handles are bent at awkward angles rendering the plough useless. It is as though somebody has purposefully impaired the plough from usage.

Hanging from the plough, you see a rusty key.

* * *

>get key
As you pick up the key, your heart jolts - you hear four loud bangs coming from the front of the cottage, like metal knocking on wood. The sound echoes around the hills and then all is silent again.

>x tree
An old, gnarled tree. The tree is bereft of leaves and extends around twenty feet into the air with menacing, claw-like branches. The tree appears to have lost several branches, and is scarred with what you presume to be lightning damage.

Tucked into a large knot in the bark of the tree you see a folded piece of paper - it appears to be a letter.

>l
Back of the Cottage
You are standing at the rear of the cottage.

On the perimeter of the clearing is an old, broken plough. You can also see an ancient gnarled tree here.

You can see page one of a letter here.

>ne
You follow the garden path around to the front of the cottage.

As you make your way around the front of the cottage, you survey the area to see if you can identify the cause of the banging. Just as you are about to resign to having imagined the sound, you observe to your horror that the field to the north is now empty. 

The scarecrow has left his post!

You can vaguely make out that something has been nailed to the post in place of the scarecrow, flapping gently in the breeze.

Please press SPACE to continue.

Front Of The Cottage
You stand in front of a large two storey cottage . A field of barley lies to the North. A path leads around the side of the cottage to the southwest. The cottage itself is directly south, the entrance blocked by a heavy oak door. 

In the field to the north you can see something nailed to a post.

>unlock door
(with the rusty key)
You unlock the Front Door.

>s
(first opening the Front Door)

The Lobby
As you enter the cottage through the heavy oak door, you disturb a number of crows who were sheltering inside. A violent fury of black feathers whip past your face as the crows exit the cottage to join their brothers in the fields. 

The lobby itself is bare and largely unfurnished, with wooden floorboards that continue south into a food preparation area, and west into a large living room. A few shelves adorn the wall and a table sits against the western wall. You feel nauseous and short of breath. Surfaces feel cold and damp to the touch.

On one of the shelves you see an old clock.

>s
The kitchen
You enter a food preparation area towards the rear of the cottage. An iron-bake oven is here hung on a trammel over a fire pit. There is an old oak table in the centre of the room, and a cupboard against the far wall.

To the north is the lobby.

>x cupboard
The dusty wooden cupboard is currently closed.

>open cupboard
You open the cupboard.

>x cupboard
It's empty!

* * *

The weather is overcast and a gentle rain is falling. The wind here is chill, and the crows are legion.

The Scarecrow
A short Napoleonic agricultural chiller by Mikey Hogarth The story genre is "Horror"
Release 1 / Serial number 130929 / Inform 7 build 6G60 (I6/v6.32 lib 6/12N) SD

The Farm Path
You are standing on a muddy farm path. A wooden gate to the south leads into a large barley field. Similar fields lead off into the distance, separated from one another by deep green foliage. 

Your journey here has been long and tiring. Beyond the field to the south you can see a thatched-roof cottage, a place you had once called home. In spite of your aching feet, the cottage no longer feels like an inviting respite .  

You see a small black cat sheltering under some nearby foliage.

>stroke cat
As you approach the cat, it flees into the undergrowth.

>s
(first opening the wooden gate)

The Barley Field
As you enter the barley field, your mind drifts to the fields of battle in the aftermath of Waterloo. The casualties were horrendous, the victory far from glorious. Many of the soldiers who died that day, the "scum of the earth" as Wellington had described them, had been recruited from villages and hamlets nearby. Wellington had later reflected that it was "really wonderful that we should have made these men into the fine fellows they are." You consider the barrenness of that statement  now that tens of thousands of those fine fellows are dead. Many of those who survived were not the same as they were before the war, having succumbed to war exhaustion or madness, or worse.

The stench of death is here, exemplified by the many dying and disease-ravaged crops left to abandonment in the surrounding fields. The chill wind is making it hard to breathe, and you begin to feel light headed. Further south through the fields you can see the old farm cottage. 

An old rotting wooden post is here. Propped up against the post, standing to attention, is a lone scarecrow.

>s
Front Of The Cottage
You approach the front of a large two storey cottage that is very familiar to you. A field of barley lies to the North. A path leads around the side of the cottage to the southwest. The cottage itself is directly south, the entrance blocked by a heavy oak door.

The crows continue to circle and caw all around, landing on the various protrusions on and around the cottage. 

You feel suddenly very sad, as if there is something at work in your soul which you do not understand.   

The small black cat from the farm path is here, washing himself among the barley.

>se
You follow garden path to the back of the cottage.

Back of the Cottage
You arrive in an ample-sized clearing of trampled barley which serves as a yard for the cottage.

You feel a slight twinge in your knee and wince in pain as you correct yourself. In that instant your thoughts turn to musket fire and the mayhem of battle, and to the sharp and sudden trauma below your right femur. 

And to falling.

You take a moment to gather your composure. You close your eyes and begin repeating to yourself "You are home. You are alive. " Eventually you open your eyes and breathe in the cold country air.

On the perimeter of the clearing is an old, broken plough. You can also see an ancient gnarled tree here.

* * *

>knock gate
You are not sure that knocking this will achieve anything.

The cat meows.

>s
(first opening the wooden gate)

The Barley Field
As you enter the barley field, your mind drifts to the fields of battle in the aftermath of Waterloo. The casualties were horrendous, the victory far from glorious. Many of the soldiers who died that day, the "scum of the earth" as Wellington had described them, had been recruited from villages and hamlets nearby. Wellington had later claimed  that it was "really wonderful that we should have made these men into the fine fellows they are." You consider the barrenness of that statement  now that tens of thousands of those fine fellows were dead. Many of those who survived were not the same as they were before the war, having succumbed to war exhaustion or madness, or worse.

The chill wind is making it hard to breathe, and you begin to feel light headed. Further south through the fields you can see the old farm cottage. 

An old rotting wooden post is here. Propped up against the post, standing to attention, is a lone scarecrow.

>s
Front Of The Cottage
You approach the front of a large two storey cottage that is very familiar to you. A field of barley lies to the North. A path leads around the side of the cottage to the southwest. The cottage itself is directly south, the entrance blocked by a heavy oak door.

>knock door
You knock on the door of the cottage, but nobody answers.

* * *

>s
(first opening the wooden gate)

The Barley Field
As you enter the barley field, your mind drifts to the fields of battle in the aftermath of Waterloo. The casualties were horrendous, the victory far from glorious. Many of the soldiers who died that day, the "scum of the earth" as Wellington had described them, had been recruited from villages and hamlets nearby. Wellington had later claimed  that it was "really wonderful that we should have made these men into the fine fellows they are." You consider the barrenness of that statement  now that tens of thousands of those fine fellows were dead. Many of those who survived were not the same as they were before the war, having succumbed to war exhaustion or madness, or worse.

The chill wind is making it hard to breathe, and you begin to feel light headed. Further south through the fields you can see the old farm cottage. 

An old rotting wooden post is here. Propped up against the post, standing to attention, is a lone scarecrow.

>s
Front Of The Cottage
You approach the front of a large two storey cottage that is very familiar to you. A field of barley lies to the North. A path leads around the side of the cottage to the southwest. The cottage itself is directly south, the entrance blocked by a heavy oak door.   

You hear the harsh "caw" of a crow.

>push door
You heave with all of your might but the heavy oak door will not budge.

It is fixed in place.

>open door
You heave with all of your might but the heavy oak door will not budge.

It seems to be locked.

* * *

I beg your pardon?

>s
Front Of The Cottage
You approach the front of a large two storey cottage that is very familiar to you. A field of barley lies to the North. A path leads around the side of the cottage to the southwest. The cottage itself is directly south, the entrance blocked by a heavy oak door.

>s
(first opening the Front Door)
You heave with all of your might but the heavy oak door will not budge. It appears to be locked.

* * *

>se
You follow garden path to the back of the cottage.

Back of the Cottage
You arrive in an ample-sized clearing of trampled barley which serves as a yard for the cottage. The fields continue off into the distance in all directions.  

On the perimeter of the clearing is an old, broken turnwrest plough.

>s
You can't go that way.

* * *

>follow gate
The wooden gate is right here.

The cat meows.

>follow cat
the cat is right here.

The cat begins scratching in the undergrowth.

>touch cat
As you approach the cat, it flees into the undergrowth.

>s
(first opening the wooden gate)

The Barley Field
As you enter the barley field, your mind drifts to the fields of battle in the aftermath of Waterloo. The casualties were horrendous, the victory far from glorious. Many of the soldiers who died that day, the "scum of the earth" as Wellington had described them, had been recruited from villages and hamlets nearby. Wellington had later claimed  that it was "really wonderful that we should have made these men into the fine fellows they are." You consider the barrenness of that statement  now that tens of thousands of those fine fellows were dead. Many of those who survived were not the same as they were before the war, having succumbed to war exhaustion or madness, or worse.

The chill wind is making it hard to breathe, and you begin to feel light headed. Further south through the fields you can see the old farm cottage. 

An old rotting wooden post is here. Propped up against the post, standing to attention, is a lone scarecrow.

>s
Front Of The Cottage
You approach the front of a large two storey cottage that is very familiar to you. A field of barley lies to the North. A path leads around the side of the cottage to the southwest. The cottage itself is directly south, the entrance blocked by a heavy oak door.   

The small black cat from the farm path is here, washing himself among the barley.

The cat meows.

>follow path
You follow garden path to the back of the cottage.

Back of the Cottage
You arrive in an ample-sized clearing of trampled barley which serves as a yard for the cottage. The fields continue off into the distance in all directions.  

On the perimeter of the clearing is an old, broken turnwrest plough.

>ne
You follow the garden path around to the front of the cottage.

Front Of The Cottage
You stand in front of a large two storey cottage . A field of barley lies to the North. A path leads around the side of the cottage to the southwest. The cottage itself is directly south, the entrance blocked by a heavy oak door.   

The small black cat from the farm path is here, washing himself among the barley.

>pet cat
The cat seems more comfortable around you now.

You hear the harsh "caw" of a crow.

The cat heads southeast to back of the cottage.

>follow cat
You can't see any such thing.

>chase cat
You can't see any such thing.

>follow myself
Wherever you go, there you are.

You feel a cool breeze.

>se
You follow garden path to the back of the cottage.

Back of the Cottage
You are standing at the rear of the cottage.

On the perimeter of the clearing is an old, broken turnwrest plough.

You can see the cat here.

The cat heads northwest to front of the cottage.

>follow cat
You can't see any such thing.

>ne
You follow the garden path around to the front of the cottage.

Front Of The Cottage
You stand in front of a large two storey cottage . A field of barley lies to the North. A path leads around the side of the cottage to the southwest. The cottage itself is directly south, the entrance blocked by a heavy oak door.   

You can see the cat here.

You hear the harsh "caw" of a crow.

>follow cat
the cat is right here.

The cat heads north to the barley field.

>n
The Barley Field
You are standing in a field of barley. To the north is a wooden gate leading to a farm path. A cottage lies to the south.

An old rotting wooden post is here. Propped up against the post, standing to attention, is a lone scarecrow.

You can also see the cat here.

The cat heads south to front of the cottage.

>s
Front Of The Cottage
You stand in front of a large two storey cottage . A field of barley lies to the North. A path leads around the side of the cottage to the southwest. The cottage itself is directly south, the entrance blocked by a heavy oak door.   

You can see the cat here.

The cat heads southeast to back of the cottage.

>se
You follow garden path to the back of the cottage.

Back of the Cottage
You are standing at the rear of the cottage.

On the perimeter of the clearing is an old, broken turnwrest plough.

You can see the cat here.

The cat begins scratching in the undergrowth.

* * *

>stroke cat
As you approach the cat, it flees into the undergrowth.

>s
(first opening the wooden gate)

The Barley Field
As you enter the barley field, your mind drifts to the fields of battle in the aftermath of Waterloo. The casualties were horrendous, the victory far from glorious. Many of the soldiers who died that day, the "scum of the earth" as Wellington had described them, had been recruited from villages and hamlets nearby. Wellington had later claimed  that it was "really wonderful that we should have made these men into the fine fellows they are." You consider the barrenness of that statement  now that tens of thousands of those fine fellows are dead. Many of those who survived were not the same as they were before the war, having succumbed to war exhaustion or madness, or worse.

The chill wind is making it hard to breathe, and you begin to feel light headed. Further south through the fields you can see the old farm cottage. 

An old rotting wooden post is here. Propped up against the post, standing to attention, is a lone scarecrow.

You hear the harsh "caw" of a crow.

>s
Front Of The Cottage
You approach the front of a large two storey cottage that is very familiar to you. A field of barley lies to the North. A path leads around the side of the cottage to the southwest. The cottage itself is directly south, the entrance blocked by a heavy oak door.  

The small black cat from the farm path is here, washing himself among the barley.

The cat tilts his head to one side.

>stroke cat
You kneel down and hold your arm out towards the cat, who responds by rubbing his face against your hand and purring loudly. He seems more comfortable around you now.

>follow cat
(heading north)

The Barley Field
You are standing in a field of barley. To the north is a wooden gate leading to a farm path. A cottage lies to the south.

An old rotting wooden post is here. Propped up against the post, standing to attention, is a lone scarecrow.

You can also see the cat here.

The cat heads south to front of the cottage.

>follow the cat
You can't see any such thing.

* * *

>follow cat
(heading north)

The Barley Field
You are standing in a field of barley. To the north is a wooden gate leading to a farm path. A cottage lies to the south.

An old rotting wooden post is here. Propped up against the post, standing to attention, is a lone scarecrow.

You can also see the cat here.

The cat heads south to front of the cottage.

>follow cat
(heading south)

Front Of The Cottage
You stand in front of a large two storey cottage . A field of barley lies to the North. A path leads around the side of the cottage to the southwest. The cottage itself is directly south, the entrance blocked by a heavy oak door.   

You can see the cat here.

You hear the harsh "caw" of a crow.

>follow path
(the garden path)
You follow garden path to the back of the cottage.

Back of the Cottage
You arrive in an ample-sized clearing of trampled barley which serves as a yard for the cottage. The fields continue off into the distance in all directions.  

On the perimeter of the clearing is an old, broken turnwrest plough.

>follow cat
It's not clear where the cat has gone.

>ne
You follow the garden path around to the front of the cottage.

Front Of The Cottage
You stand in front of a large two storey cottage . A field of barley lies to the North. A path leads around the side of the cottage to the southwest. The cottage itself is directly south, the entrance blocked by a heavy oak door.   

You can see the cat here.

The cat meows.

>n
The Barley Field
You are standing in a field of barley. To the north is a wooden gate leading to a farm path. A cottage lies to the south.

An old rotting wooden post is here. Propped up against the post, standing to attention, is a lone scarecrow.

The cat arrives from the south.

* * *

>stroke cat
You kneel down and hold your arm out towards the cat, who responds by rubbing his face against your hand and purring loudly. He seems more comfortable around you now.

>stroke cat
The cat purrs loudly.

You feel a cool breeze.

>stroke cat
The cat rubs his face against your leg.

The cat meows.

>stroke cat
The cat purrs loudly.

You hear the harsh "caw" of a crow.

The cat heads southeast to back of the cottage.

* * *

>ss
That's not a verb I recognise.

>s
(first opening the wooden gate)

The Barley Field
As you enter the barley field, your mind drifts to the fields of battle in the aftermath of Waterloo. The casualties were horrendous, the victory far from glorious. Many of the soldiers who died that day, the "scum of the earth" as Wellington had described them, had been recruited from villages and hamlets nearby. Wellington had later claimed  that it was "really wonderful that we should have made these men into the fine fellows they are." You consider the barrenness of that statement  now that tens of thousands of those fine fellows are dead. Many of those who survived were not the same as they were before the war, having succumbed to war exhaustion or madness, or worse.

The chill wind is making it hard to breathe, and you begin to feel light headed. Further south through the fields you can see the old farm cottage. 

An old rotting wooden post is here. Propped up against the post, standing to attention, is a lone scarecrow.

>s
Front Of The Cottage
You approach the front of a large two storey cottage that is very familiar to you. A field of barley lies to the North. A path leads around the side of the cottage to the southwest. The cottage itself is directly south, the entrance blocked by a heavy oak door.   

You hear the harsh "caw" of a crow.

>se
You follow garden path to the back of the cottage.

Back of the Cottage
You arrive in an ample-sized clearing of trampled barley which serves as a yard for the cottage. The fields continue off into the distance in all directions.  

On the perimeter of the clearing is an old, broken turnwrest plough.

>x plough
In addition to the rust and general disrepair of the plough, the cumbersome plough also appears to have been damaged - the blades and handles are bent at awkward angles rendering the plough useless.

Hanging from the plough, you see a rusty key.

* * *

>get key
As you pick up the key, your heart jolts - you hear four loud bangs coming from the front of the cottage, like metal knocking on wood. The sound echoes around the hills and then all is silent again.

>ne
You follow the garden path around to the front of the cottage.

Front Of The Cottage
You stand in front of a large two storey cottage . A field of barley lies to the North. A path leads around the side of the cottage to the southwest. The cottage itself is directly south, the entrance blocked by a heavy oak door. 

As you make your way around the front of the cottage, you survey the area to see if you can identify the cause of the banging. Just as you are about to resign to having imagined the sound, you observe to your horror that the field to the north is now empty. The scarecrow has left his post! You can vaguely make out that something has been nailed to the post in place of the scarecrow, flapping gently in the breeze.

>n
OMG NO SCARECROW!

Please press SPACE to continue.

* * *

The Barley Field
You are standing in a field of barley. To the north is a wooden gate leading to a farm path. A cottage lies to the south.

An old rotting wooden post is here. 

On the post is a note.

* * *

>x cat
The cat stares at you with wide yellow eyes which convey both curiosity and caution in equal measures.

As you watch the cat, you suddenly become aware of a letter on the ground next to him, previously obscured.

The cat meows.

>l
The Farm Path
A wooden gate to the south leads to a field of barley. 

You see a small black cat sheltering under some nearby foliage.

You can see page one of a letter here.

You hear the harsh "caw" of a crow.

>x letter
letter 1.

You hear the harsh "caw" of a crow.

* * *

>l
The Farm Path
A wooden gate to the south leads to a field of barley. 

You see a small black cat sheltering under some nearby foliage.

You can see page one of a letter here.

You hear the harsh "caw" of a crow.

>get letter
Taken.

>i
You are carrying:
  page one of a letter

>read letter
General Hospital, Antwerp, 24th June 1815. After a long silence, I embrace the opportunity of informing you respecting my present situation. On the 15th, about 12 o'clock at night, we turned out and at two in the morning marched from the city of Brussels, to meet the enemy, who were advancing in great force on that city. About three o'clock in the afternoon of the 16th, we came up with them. Our whole force did not exceed 12,000 men, who were fatigued with a long march of upwards of 20 miles, encumbered with knapsacks and other luggage. The day was uncommonly warm, and no water to be had on the road; however, we were brought up, in order of battle. The French being strongly posted in a thick wood, to the number of 40,000 men, including cavalry and lancers, gave us very little time to look around us ere the fight commenced on both sides, in an awful and destructive manner, they having every advantage of us, both as to position and numbers, particularly in cavalry, as the British dragoons had not yet come up.

You hear the harsh "caw" of a crow.

The cat meows.

* * *

>get letter
Taken.

>x letter
General Hospital, Antwerp, 24th June 1815. After a long silence, I embrace the opportunity of informing you respecting my present situation. On the 15th, about 12 o'clock at night, we turned out and at two in the morning marched from the city of Brussels, to meet the enemy, who were advancing in great force on that city. About three o'clock in the afternoon of the 16th, we came up with them. Our whole force did not exceed 12,000 men, who were fatigued with a long march of upwards of 20 miles, encumbered with knapsacks and other luggage. The day was uncommonly warm, and no water to be had on the road; however, we were brought up, in order of battle. The French being strongly posted in a thick wood, to the number of 40,000 men, including cavalry and lancers, gave us very little time to look around us ere the fight commenced on both sides, in an awful and destructive manner, they having every advantage of us, both as to position and numbers, particularly in cavalry, as the British dragoons had not yet come up.

The cat begins scratching in the undergrowth.

* * *

>l
The Farm Path
A wooden gate to the south leads to a field of barley. 

You see a small black cat sheltering under some nearby foliage.

You can see page one of a letter here.

You hear the harsh "caw" of a crow.

>read letter
letter 1.

The cat meows.

* * *

>l
The Farm Path
A wooden gate to the south leads to a field of barley. 

You see a small black cat sheltering under some nearby foliage.

You can see page one of a letter here.

You hear the harsh "caw" of a crow.

>s
(first opening the wooden gate)

The Barley Field
As you enter the barley field, your mind drifts to the fields of battle in the aftermath of Waterloo. The casualties were horrendous, the victory far from glorious. Many of the soldiers who died that day, the "scum of the earth" as Wellington had described them, had been recruited from villages and hamlets nearby. Wellington had later claimed  that it was "really wonderful that we should have made these men into the fine fellows they are." You consider the barrenness of that statement  now that tens of thousands of those fine fellows are dead. Many of those who survived were not the same as they were before the war, having succumbed to war exhaustion or madness, or worse.

The chill wind is making it hard to breathe, and you begin to feel light headed. Further south through the fields you can see the old farm cottage. 

An old rotting wooden post is here. Propped up against the post, standing to attention, is a lone scarecrow.

>x coat
A tattered red coat.

As you run your fingers along the hem of one of the sleeves, a folded piece of paper falls from one of the inside pockets. It appears to be a letter.

* * *

>l
The Barley Field
You are standing in a field of barley. To the north is a wooden gate leading to a farm path. A cottage lies to the south.

An old rotting wooden post is here. Propped up against the post, standing to attention, is a lone scarecrow.

You can also see page two of a letter here.

>get all
page two of a letter: Taken.

>n
The Farm Path
A wooden gate to the south leads to a field of barley. 

You see a small black cat sheltering under some nearby foliage.

You can see page one of a letter here.

You feel a cool breeze.

>get all
page one of a letter: Taken.

>i
You are carrying:
  page one of a letter
  page two of a letter

You hear the harsh "caw" of a crow.

>x letter
Which do you mean, page one of a letter or page two of a letter?

>page one
You start the letter:

   
General Hospital, Antwerp, 24th June 1815. After a long silence, I embrace the opportunity of informing you respecting my present situation. On the 15th, about 12 o'clock at night, we turned out and at two in the morning marched from the city of Brussels, to meet the enemy, who were advancing in great force on that city. About three o'clock in the afternoon of the 16th, we came up with them. Our whole force did not exceed 12,000 men, who were fatigued with a long march of upwards of 20 miles, encumbered with knapsacks and other luggage. The day was uncommonly warm, and no water to be had on the road; however, we were brought up, in order of battle. The French being strongly posted in a thick wood, to the number of 40,000 men, including cavalry and lancers, gave us very little time to look around us ere the fight commenced on both sides, in an awful and destructive manner, they having every advantage of us, both as to position and numbers, particularly in cavalry, as the British dragoons had not yet come up.

A scrawl at the bottom of the letter indicates that this is part 1 of 4.

You feel a cool breeze.

The cat begins scratching in the undergrowth.

>x page two
You start the letter:

   
The French cavalry charged the British line of infantry three different times, and did much execution, until we were obliged to form squares of battalions, in order to turn them, which was executed in a most gallant manner, and many hundreds of them never returned. Still, they sent up French forces and as often we beat them them back. The battle lasted until it was quite dark, when the enemy began to give way, our poor fellows who were left alive following them as long as they could see, when night put an end to the fatigues of a well fought day. Thousands on both sides lay killed and wounded on the field of battle; and, as the greater part of the action lay in corn fields along a vast track of country, many hundreds must have died for want of assistance through the night, who were not able of themselves to crawl away.

A scrawl at the bottom of the letter indicates that this is part 4 of 4.

The cat meows.

* * *

>x cat
The cat stares at you with wide yellow eyes which convey both curiosity and caution in equal measures.

As you watch the cat, you suddenly become aware of a letter on the ground next to him, previously obscured.

The cat meows.

>get letter
Taken.

The cat meows.

>read letter
letter 1.

>i
You are carrying:
  a first letter

* * *

>get letter
Taken.

The cat meows.

>i
You are carrying:
  An old letter (part 1)

>x letter
General Hospital, Antwerp, 24th June 1815. After a long silence, I embrace the opportunity of informing you respecting my present situation. On the 15th, about 12 o'clock at night, we turned out and at two in the morning marched from the city of Brussels, to meet the enemy, who were advancing in great force on that city. About three o'clock in the afternoon of the 16th, we came up with them. Our whole force did not exceed 12,000 men, who were fatigued with a long march of upwards of 20 miles, encumbered with knapsacks and other luggage. The day was uncommonly warm, and no water to be had on the road; however, we were brought up, in order of battle. The French being strongly posted in a thick wood, to the number of 40,000 men, including cavalry and lancers, gave us very little time to look around us ere the fight commenced on both sides, in an awful and destructive manner, they having every advantage of us, both as to position and numbers, particularly in cavalry, as the British dragoons had not yet come up.

>x cat
The cat stares at you with wide yellow eyes which convey both curiosity and caution in equal measures.

* * *

>get letter
Taken.

The cat meows.

>x letter
You start reading the page one of a letter
General Hospital, Antwerp, 24th June 1815. After a long silence, I embrace the opportunity of informing you respecting my present situation. On the 15th, about 12 o'clock at night, we turned out and at two in the morning marched from the city of Brussels, to meet the enemy, who were advancing in great force on that city. About three o'clock in the afternoon of the 16th, we came up with them. Our whole force did not exceed 12,000 men, who were fatigued with a long march of upwards of 20 miles, encumbered with knapsacks and other luggage. The day was uncommonly warm, and no water to be had on the road; however, we were brought up, in order of battle. The French being strongly posted in a thick wood, to the number of 40,000 men, including cavalry and lancers, gave us very little time to look around us ere the fight commenced on both sides, in an awful and destructive manner, they having every advantage of us, both as to position and numbers, particularly in cavalry, as the British dragoons had not yet come up.

You hear the harsh "caw" of a crow.

The cat begins scratching in the undergrowth.

* * *

>x cat
The cat stares at you with wide yellow eyes which convey both curiosity and caution in equal measures.

As you watch the cat, you suddenly become aware of a letter on the ground next to him, previously obscured.

The cat meows.

>s
(first opening the wooden gate)

The Barley Field
As you enter the barley field, your mind drifts to the fields of battle in the aftermath of Waterloo. The casualties were horrendous, the victory far from glorious. Many of the soldiers who died that day, the "scum of the earth" as Wellington had described them, had been recruited from villages and hamlets nearby. Wellington had later claimed  that it was "really wonderful that we should have made these men into the fine fellows they are." You consider the barrenness of that statement  now that tens of thousands of those fine fellows are dead. Many of those who survived were not the same as they were before the war, having succumbed to war exhaustion or madness, or worse.

The chill wind is making it hard to breathe, and you begin to feel light headed. Further south through the fields you can see the old farm cottage. 

An old rotting wooden post is here. Propped up against the post, standing to attention, is a lone scarecrow.

>n
The Farm Path
A wooden gate to the south leads to a field of barley. 

You see a small black cat sheltering under some nearby foliage.

You can see page one of a letter here.

The cat begins scratching in the undergrowth.

>get page one
You can't see any such thing.

* * *

>x cat
The cat stares at you with wide yellow eyes which convey both curiosity and caution in equal measures.

As you watch the cat, you suddenly become aware of a letter on the ground next to him, previously obscured.

The cat meows.

>get page one
Taken.

The cat meows.

* * *

>x cat
The cat stares at you with wide yellow eyes which convey both curiosity and caution in equal measures.

As you watch the cat, you suddenly become aware of a letter on the ground next to him, previously obscured.

The cat meows.

>get page one of letter
I only understood you as far as wanting to get page one of a letter.

>l,
The Farm Path
A wooden gate to the south leads to a field of barley. 

You see a small black cat sheltering under some nearby foliage.

You can see page one of a letter here.

You hear the harsh "caw" of a crow.

The cat begins scratching in the undergrowth.

>l
The Farm Path
A wooden gate to the south leads to a field of barley. 

You see a small black cat sheltering under some nearby foliage.

You can see page one of a letter here.

You feel a cool breeze.

>get letter
Taken.

The cat meows.

* * *

>x cat
The cat stares at you with wide yellow eyes which convey both curiosity and caution in equal measures.

As you watch the cat, you suddenly become aware of a letter on the ground next to him, previously obscured.

The cat meows.

>x letter
You start reading page one of a letter

General Hospital, Antwerp, 24th June 1815. After a long silence, I embrace the opportunity of informing you respecting my present situation. On the 15th, about 12 o'clock at night, we turned out and at two in the morning marched from the city of Brussels, to meet the enemy, who were advancing in great force on that city. About three o'clock in the afternoon of the 16th, we came up with them. Our whole force did not exceed 12,000 men, who were fatigued with a long march of upwards of 20 miles, encumbered with knapsacks and other luggage. The day was uncommonly warm, and no water to be had on the road; however, we were brought up, in order of battle. The French being strongly posted in a thick wood, to the number of 40,000 men, including cavalry and lancers, gave us very little time to look around us ere the fight commenced on both sides, in an awful and destructive manner, they having every advantage of us, both as to position and numbers, particularly in cavalry, as the British dragoons had not yet come up.

* * *

>x cart
You can't see any such thing.

>x cat
The cat stares at you with wide yellow eyes which convey both curiosity and caution in equal measures.

letter baby 1
The cat meows.

>x cat
The cat stares at you with wide yellow eyes which convey both curiosity and caution in equal measures.

You hear the harsh "caw" of a crow.

The cat begins scratching in the undergrowth.

* * *

>x catr
You can't see any such thing.

>x cat
The cat stares at you with wide yellow eyes which convey both curiosity and caution in equal measures.

As you watch the cat, you suddenly become aware of a letter on the ground next to him, previously obscured.

The cat meows.

>l
The Farm Path
A wooden gate to the south leads to a field of barley. 

You see a small black cat sheltering under some nearby foliage.

You can see The first letter here.

The cat begins scratching in the undergrowth.

* * *

>x ca
You can't see any such thing.

>x cat
The cat stares at you with wide yellow eyes which convey both curiosity and caution in equal measures.

As you watch the cat, you suddenly become aware of a letter on the ground next to him, previously obscured.

The cat meows.

>x letter
foo
You hear the harsh "caw" of a crow.

The cat begins scratching in the undergrowth.

* * *

>x at
You can't see any such thing.

>x cat
The cat stares at you with wide yellow eyes which convey both curiosity and caution in equal measures.

As you watch the cat, you suddenly become aware of a letter on the ground next to him, previously obscured.

>l
The Farm Path
A wooden gate to the south leads to a field of barley. 

You see a small black cat sheltering under some nearby foliage.

You can see page one of a letter here.

The cat meows.

>get letter
Taken.

You hear the harsh "caw" of a crow.

The cat begins scratching in the undergrowth.

>read letter
You start reading page one of a letter

General Hospital, Antwerp, 24th June 1815. After a long silence, I embrace the opportunity of informing you respecting my present situation. On the 15th, about 12 o'clock at night, we turned out and at two in the morning marched from the city of Brussels, to meet the enemy, who were advancing in great force on that city. About three o'clock in the afternoon of the 16th, we came up with them. Our whole force did not exceed 12,000 men, who were fatigued with a long march of upwards of 20 miles, encumbered with knapsacks and other luggage. The day was uncommonly warm, and no water to be had on the road; however, we were brought up, in order of battle. The French being strongly posted in a thick wood, to the number of 40,000 men, including cavalry and lancers, gave us very little time to look around us ere the fight commenced on both sides, in an awful and destructive manner, they having every advantage of us, both as to position and numbers, particularly in cavalry, as the British dragoons had not yet come up.

You feel a cool breeze.

The cat meows.

* * *

>z
Time passes.

>z
Time passes.

>z
Time passes.

You hear the harsh "caw" of a crow.

>z
Time passes.

The cat tilts his head to one side.

>z
Time passes.

>z
Time passes.

The cat tilts his head to one side.

>x cat
The cat stares at you with wide yellow eyes which convey both curiosity and caution in equal measures.

>stroke cat
As you approach the cat, it flees into the undergrowth.

>x cat
You can't see any such thing.

>s
(first opening the wooden gate)

The Barley Field
As you enter the barley field, your mind drifts to the fields of battle in the aftermath of Waterloo. The casualties were horrendous, the victory far from glorious. Many of the soldiers who died that day, the "scum of the earth" as Wellington had described them, had been recruited from villages and hamlets nearby. Wellington had later claimed  that it was "really wonderful that we should have made these men into the fine fellows they are." You consider the barrenness of that statement  now that tens of thousands of those fine fellows are dead. Many of those who survived were not the same as they were before the war, having succumbed to war exhaustion or madness, or worse.

The chill wind is making it hard to breathe, and you begin to feel light headed. Further south through the fields you can see the old farm cottage. 

An old rotting wooden post is here. Propped up against the post, standing to attention, is a lone scarecrow.

>s
Front Of The Cottage
You approach the front of a large two storey cottage that is very familiar to you. A field of barley lies to the North. A path leads around the side of the cottage to the southwest. The cottage itself is directly south, the entrance blocked by a heavy oak door.  

The small black cat from the farm path is here, washing himself among the barley.

The cat blinks slowly.

* * *

>x cat
A small black cat with wide, yellow eyes. The cat is wearing a silver collar.

>x collar
The cat edges away warily before you can get close enough.

The cat tilts his head to one side.

>stroke cat
The cat seems more comfortable around you now.

The cat heads north to the barley field.

>n
The Barley Field
You are standing in a field of barley. To the north is a wooden gate leading to a farm path. A cottage lies to the south.

An old rotting wooden post is here. Propped up against the post, standing to attention, is a lone scarecrow.

You can also see the cat here.

>x collar
The cats name is Wellington.

You hear the harsh "caw" of a crow.

Wellington meows.

>n
The Farm Path
A wooden gate to the south leads to a field of barley.

>s
The Barley Field
You are standing in a field of barley. To the north is a wooden gate leading to a farm path. A cottage lies to the south.

An old rotting wooden post is here. Propped up against the post, standing to attention, is a lone scarecrow.

>s
Front Of The Cottage
You stand in front of a large two storey cottage . A field of barley lies to the North. A path leads around the side of the cottage to the southwest. The cottage itself is directly south, the entrance blocked by a heavy oak door.  

Wellington arrives from the southeast.

>x wellington
A small black cat with wide, yellow eyes. The cat is wearing a silver collar.

Wellington heads southeast to back of the cottage.

>se
You follow garden path to the back of the cottage.

Back of the Cottage
You arrive in an ample-sized clearing of trampled barley which serves as a yard for the cottage. The fields continue off into the distance in all directions.  

On the perimeter of the clearing is an old, broken turnwrest plough.

You can see Wellington here.

Wellington heads northwest to front of the cottage.

>x plough
In addition to the rust and general disrepair of the plough, the cumbersome plough also appears to have been damaged - the blades and handles are bent at awkward angles rendering the plough useless.

Hanging from the plough, you see a rusty key.

Wellington arrives from the northwest.

>get key
As you pick up the key, your heart jolts - you hear four loud bangs coming from the front of the cottage, like metal knocking on wood. The sound echoes around the hills and then all is silent again.

>ne
You follow the garden path around to the front of the cottage.

As you make your way around the front of the cottage, you survey the area to see if you can identify the cause of the banging. Just as you are about to resign to having imagined the sound, you observe to your horror that the field to the north is now empty. The scarecrow has left his post! You can vaguely make out that something has been nailed to the post in place of the scarecrow, flapping gently in the breeze.

Please press SPACE to continue.

* * *

>z
Time passes.

The cat tilts his head to one side.

>stroke cat
As you approach the cat, it flees into the undergrowth.

>s
(first opening the wooden gate)

The Barley Field
As you enter the barley field, your mind drifts to the fields of battle in the aftermath of Waterloo. The casualties were horrendous, the victory far from glorious. Many of the soldiers who died that day, the "scum of the earth" as Wellington had described them, had been recruited from villages and hamlets nearby. Wellington had later claimed  that it was "really wonderful that we should have made these men into the fine fellows they are." You consider the barrenness of that statement  now that tens of thousands of those fine fellows are dead. Many of those who survived were not the same as they were before the war, having succumbed to war exhaustion or madness, or worse.

The chill wind is making it hard to breathe, and you begin to feel light headed. Further south through the fields you can see the old farm cottage. 

An old rotting wooden post is here. Propped up against the post, standing to attention, is a lone scarecrow.

>s
Front Of The Cottage
You approach the front of a large two storey cottage that is very familiar to you. A field of barley lies to the North. A path leads around the side of the cottage to the southwest. The cottage itself is directly south, the entrance blocked by a heavy oak door.  

The small black cat from the farm path is here, washing himself among the barley.

The cat blinks slowly and stares at you.

* * *

>x undergrowth
Deep green foliage serves as a natural barrier separating the fields.

Something in the nearby undergrowth catches your eye - it appears to be a letter.

>l
The Farm Path
A wooden gate to the south leads to a field of barley. 

You see a small black cat sheltering under some nearby foliage.

You can see page one of a letter here.

You hear the harsh "caw" of a crow.

The cat tilts his head to one side.

>s
(first opening the wooden gate)

The Barley Field
As you enter the barley field, your mind drifts to the fields of battle in the aftermath of Waterloo. The casualties were horrendous, the victory far from glorious. Many of the soldiers who died that day, the "scum of the earth" as Wellington had described them, had been recruited from villages and hamlets nearby. Wellington had later claimed  that it was "really wonderful that we should have made these men into the fine fellows they are." You consider the barrenness of that statement  now that tens of thousands of those fine fellows are dead. Many of those who survived were not the same as they were before the war, having succumbed to war exhaustion or madness, or worse.

The chill wind is making it hard to breathe, and you begin to feel light headed. Further south through the fields you can see the old farm cottage. 

An old rotting wooden post is here. Propped up against the post, standing to attention, is a lone scarecrow.

>x corn
Acres of barley, wheat and oat stretch over the horizon. The fields are wild and unkempt. Many of the crops have been ravaged by disease.

In amongst the crop here you see a folded piece of paper. It appears to be a letter.

>l
The Barley Field
You are standing in a field of barley. To the north is a wooden gate leading to a farm path. A cottage lies to the south.

An old rotting wooden post is here. Propped up against the post, standing to attention, is a lone scarecrow.

You can also see page two of a letter here.

You feel a cool breeze.

>s
Front Of The Cottage
You approach the front of a large two storey cottage that is very familiar to you. A field of barley lies to the North. A path leads around the side of the cottage to the southwest. The cottage itself is directly south, the entrance blocked by a heavy oak door.

>n
The Barley Field
You are standing in a field of barley. To the north is a wooden gate leading to a farm path. A cottage lies to the south.

An old rotting wooden post is here. Propped up against the post, standing to attention, is a lone scarecrow.

You can also see page two of a letter here.

>x coat
A tattered red coat.

As you run your fingers along the hem of one of the sleeves, a folded piece of paper falls from one of the inside pockets. It appears to be a letter.

>l
The Barley Field
You are standing in a field of barley. To the north is a wooden gate leading to a farm path. A cottage lies to the south.

An old rotting wooden post is here. Propped up against the post, standing to attention, is a lone scarecrow.

You can also see page three of a letter and page two of a letter here.

>get all
page three of a letter: Taken.
page two of a letter: Taken.

>read letter
Which do you mean, page two of a letter or page three of a letter?

>n
I only understood you as far as wanting to read north.

>n
The Farm Path
A wooden gate to the south leads to a field of barley. 

You see a small black cat sheltering under some nearby foliage.

You can see page one of a letter here.

You hear the harsh "caw" of a crow.

>get letter
(page one of a letter)
Taken.

The cat blinks slowly.

>s
The Barley Field
You are standing in a field of barley. To the north is a wooden gate leading to a farm path. A cottage lies to the south.

An old rotting wooden post is here. Propped up against the post, standing to attention, is a lone scarecrow.

* * *

>s
Front Of The Cottage
You stand in front of a large two storey cottage . A field of barley lies to the North. A path leads around the side of the cottage to the southwest. The cottage itself is directly south, the entrance blocked by a heavy oak door.

>se
You follow garden path to the back of the cottage.

Back of the Cottage
You arrive in an ample-sized clearing of trampled barley which serves as a yard for the cottage. The fields continue off into the distance in all directions.  

On the perimeter of the clearing is an old, broken turnwrest plough.

* * *

>n
The Barley Field
You are standing in a field of barley. To the north is a wooden gate leading to a farm path. A cottage lies to the south.

An old rotting wooden post is here. 

On the post is a note.

>read note
There is a message inscribed onto the note in what looks like charcoal. The author has used aggressive straight lines to etch out each letter. The message reads:

"Your place is in the fields"

>s
Front Of The Cottage
You stand in front of a large two storey cottage . A field of barley lies to the North. A path leads around the side of the cottage to the southwest. The cottage itself is directly south, the entrance blocked by a heavy oak door. 

In the field to the north you can see something nailed to a post. 

You see a strange figure at one of the cottage's upper windows. 

You feel a cool breeze.

>x figure
You see a strange figure at the window.

As your eyes begin to focus more clearly, the figure fades from view. Was it even there in the first place?

>l
Front Of The Cottage
You stand in front of a large two storey cottage . A field of barley lies to the North. A path leads around the side of the cottage to the southwest. The cottage itself is directly south, the entrance blocked by a heavy oak door. 

In the field to the north you can see something nailed to a post.  

You hear the harsh "caw" of a crow.

>s
(first opening the Front Door)
You heave with all of your might but the heavy oak door will not budge. It appears to be locked.

>unlock door with key
You unlock the Front Door.

>s
(first opening the Front Door)

The Lobby
 As you enter the cottage through the heavy oak door, you disturb a murder of crows who were sheltering inside. A violent fury of black feathers whip past your face as the crows exit the cottage to join their brothers in the fields. 

The lobby itself is bare and largely unfurnished, with wooden floorboards that continue south into a food preparation area, and west into a large living room. A few shelves adorn the wall and a table sits against the western wall. You feel nauseous and short of breath. Surfaces feel cold and damp to the touch. 

You can see a shelf (on which is a clock) here.

* * *

>x table
A simple wooden table.

Tucked into the woodwork beneath the table, you find a folded piece of paper. It appears to be a letter.

>l
The Lobby
  You are in the lobby. The room is large and mostly empty, save for a few shelves. The kitchen is to the north, while to the west is the living room. 

You can see page four of a letter and a shelf (on which is a clock) here.

>get letter
(page four of a letter)
Taken.

>read letter
Which do you mean, page four of a letter, page one of a letter, page two of a letter or page three of a letter?

>page four
You start the letter:

   
Thus I have given you as full an account of affairs, principally what I witnessed on the 16th, as I could; that relating to the 18th being from report. Nothing can exceed the kindness and attention of the inhabitants of this city to our wounded men : the hospital is constantly filled with ladies and gentlemen, who, although speaking a different language, personally administer to our wants, with the kindest attention, distributing clean shirts, bread, wine, coffee, tea, milk and fruit of all sorts, with every requisite, for our comfort and accommodation.

A scrawl at the bottom of the letter indicates that this is the end of the letter.

* * *

>e
The path extends far into the distance. You have travelled far to get here, you see no reason to leave now.

>w
The path extends far into the distance. You have travelled far to get here, you see no reason to leave now.

* * *

>talk to cat
I didn't understand that sentence.

>ask cat about weather
There is no reply.

>ask gate about weather
You can only do that to something animate.

>s
(first opening the wooden gate)

The Barley Field
As you enter the barley field, your mind drifts to the fields of battle in the aftermath of Waterloo. The casualties were horrendous, the victory far from glorious. Many of the soldiers who died that day, the "scum of the earth" as Wellington had described them, had been recruited from villages and hamlets nearby. Wellington had later claimed  that it was "really wonderful that we should have made these men into the fine fellows they are." You consider the barrenness of that statement  now that tens of thousands of those fine fellows are dead. Many of those who survived were not the same as they were before the war, having succumbed to war exhaustion or madness, or worse.

The chill wind is making it hard to breathe, and you begin to feel light headed. Further south through the fields you can see the old farm cottage. 

An old rotting wooden post is here. Propped up against the post, standing to attention, is a lone scarecrow.

>ask scarecrow about weather
There is no reply.

>s
Front Of The Cottage
You approach the front of a large two storey cottage that is very familiar to you. A field of barley lies to the North. A path leads around the side of the cottage to the southwest. The cottage itself is directly south, the entrance blocked by a heavy oak door.

>ask cottage about something
You can only do that to something animate.

>n
The Barley Field
You are standing in a field of barley. To the north is a wooden gate leading to a farm path. A cottage lies to the south.

An old rotting wooden post is here. Propped up against the post, standing to attention, is a lone scarecrow.

You hear the harsh "caw" of a crow.

* * *

>meow at cat
You meow at the cat.

The cat tilts his head to one side.

>meow at gate
You can only do that to something animate.

* * *

>meow at cat
You meow at the cat.

The cat tilts his head to one side.

>touch cat
As you approach the cat, it flees into the undergrowth.

>s
(first opening the wooden gate)

The Barley Field
As you enter the barley field, your mind drifts to the fields of battle in the aftermath of Waterloo. The casualties were horrendous, the victory far from glorious. Many of the soldiers who died that day, the "scum of the earth" as Wellington had described them, had been recruited from villages and hamlets nearby. Wellington had later claimed  that it was "really wonderful that we should have made these men into the fine fellows they are." You consider the barrenness of that statement  now that tens of thousands of those fine fellows are dead. Many of those who survived were not the same as they were before the war, having succumbed to war exhaustion or madness, or worse.

The chill wind is making it hard to breathe, and you begin to feel light headed. Further south through the fields you can see the old farm cottage. 

An old rotting wooden post is here. Propped up against the post, standing to attention, is a lone scarecrow.

>s
Front Of The Cottage
You approach the front of a large two storey cottage that is very familiar to you. A field of barley lies to the North. A path leads around the side of the cottage to the southwest. The cottage itself is directly south, the entrance blocked by a heavy oak door.  

The small black cat from the farm path is here, washing himself among the barley.

>meow at cat
The cat seems more comfortable around you now.

The cat heads southeast to back of the cottage.

>meow at cottage
You meow at the Cottage.

>n
The Barley Field
You are standing in a field of barley. To the north is a wooden gate leading to a farm path. A cottage lies to the south.

An old rotting wooden post is here. Propped up against the post, standing to attention, is a lone scarecrow.

* * *

>meow at cat
You meow at the cat.

The cat tilts his head to one side.

>stroke cat
As you approach the cat, it flees into the undergrowth.

* * *

>s
Front Of The Cottage
You approach the front of a large two storey cottage that is very familiar to you. A field of barley lies to the North. A path leads around the side of the cottage to the southwest. The cottage itself is directly south, the entrance blocked by a heavy oak door.  

The small black cat from the farm path is here, washing himself among the barley.

>meow at cat
You abandon your sensibilities for a moment, stare the cat straight in the eyes, and meow. To your suprise, he meows back. He seems more comfortable around you now.

You hear the harsh "caw" of a crow.

* * *

>meow at gate
You meow at the wooden gate.

>meow at cat
You meow at the cat.

You hear the harsh "caw" of a crow.

* * *

>touch cat
As you approach the cat, it flees into the undergrowth.

* * *

>s
Front Of The Cottage
You approach the front of a large two storey cottage that is very familiar to you. A field of barley lies to the North. A path leads around the side of the cottage to the southwest. The cottage itself is directly south, the entrance blocked by a heavy oak door.  

The small black cat from the farm path is here, washing himself among the barley.

The cat tilts his head to one side.

>touch cat
The cat seems more comfortable around you now.

* * *

>stroke kitty
As you approach the cat, it flees into the undergrowth.

>s
(first opening the wooden gate)

The Barley Field
As you enter the barley field, your mind drifts to the fields of battle in the aftermath of Waterloo. The casualties were horrendous, the victory far from glorious. Many of the soldiers who died that day, the "scum of the earth" as Wellington had described them, had been recruited from villages and hamlets nearby. Wellington had later claimed  that it was "really wonderful that we should have made these men into the fine fellows they are." You consider the barrenness of that statement  now that tens of thousands of those fine fellows are dead. Many of those who survived were not the same as they were before the war, having succumbed to war exhaustion or madness, or worse.

The chill wind is making it hard to breathe, and you begin to feel light headed. Further south through the fields you can see the old farm cottage. 

An old rotting wooden post is here. Propped up against the post, standing to attention, is a lone scarecrow.

>x scarecrow
The scarecrow is wearing a tattered red coat and a pair of old grey trousers. Black rubber boots and a shapeless cloth hat with a wide, crinkly brim complete the outfit.

The scarecrow's head is made from a hessian sack, onto which has been drawn the approximation of a face. You can not tell whether the scarecrow is smiling or frowning, and his eyes stare blankly through you. The scarecrow is soaked through with rain - he has clearly been standing in this field for some time.

As you stare at the scarecrow, you feel a deep nausea as you come to accept an affinity with him. You consider the folly in his defence of fields that have been abandoned and ravaged by disease. His battlefield is a barren waste, his war over. He has been standing here so long, the crows are no longer afraid of him. Perhaps now the fight is over, they are his only companions.

>x coat
A tattered red coat.

As you run your fingers along the hem of one of the sleeves, a folded piece of paper falls from one of the inside pockets. It appears to be a letter.

>l
The Barley Field
You are standing in a field of barley. To the north is a wooden gate leading to a farm path. A cottage lies to the south.

An old rotting wooden post is here. Propped up against the post, standing to attention, is a lone scarecrow.

You can also see page one of a letter here.

>n
The Farm Path
A wooden gate to the south leads to a field of barley. 

You hear the harsh "caw" of a crow.

>x undergrowth
Deep green foliage serves as a natural barrier separating the fields.

Something in the nearby undergrowth catches your eye - it appears to be a letter.

>l
The Farm Path
A wooden gate to the south leads to a field of barley. 

You can see page two of a letter here.

You feel a cool breeze.

>s
The Barley Field
You are standing in a field of barley. To the north is a wooden gate leading to a farm path. A cottage lies to the south.

An old rotting wooden post is here. Propped up against the post, standing to attention, is a lone scarecrow.

You can also see page one of a letter here.

You hear the harsh "caw" of a crow.

>s
Front Of The Cottage
You approach the front of a large two storey cottage that is very familiar to you. A field of barley lies to the North. A path leads around the side of the cottage to the southwest. The cottage itself is directly south, the entrance blocked by a heavy oak door.  

The small black cat from the farm path is here, washing himself among the barley.

The cat tilts his head to one side.

>se
You follow garden path to the back of the cottage.

Back of the Cottage
You arrive in an ample-sized clearing of trampled barley which serves as a yard for the cottage. The fields continue off into the distance in all directions.  

On the perimeter of the clearing is an old, broken turnwrest plough.

>x crows
Yay, crows.

* * *

>help
You can go north and stuff.

* * *

The weather is overcast and a gentle rain is falling. The wind is chill, and the crows are legion.

The Scarecrow
A short Napoleonic agricultural chiller by Mikey Hogarth The story genre is "Horror"
Release 1 / Serial number 131001 / Inform 7 build 6G60 (I6/v6.32 lib 6/12N) SD

The Farm Path
You are standing on a muddy farm path. A wooden gate to the south leads into a large barley field. Similar fields lead off into the distance, separated from one another by deep green foliage. 

A low mist hangs in the air. Your journey here has been long and tiring. Beyond the field to the south you can see the silhouette of a thatched cottage, a place you had once called home. In spite of your aching feet, the cottage does not feel like an inviting respite.  

You see a small black cat sheltering under some nearby foliage.

>n
Thick foliage prevents passage to the North.

The cat tilts his head to one side.

What would you like to do?

>s
(first opening the wooden gate)

The Barley Field
As you enter the barley field, your mind drifts to the fields of battle in the aftermath of Waterloo. The casualties were horrendous, the victory far from glorious. Many of the soldiers who died that day, the "scum of the earth" as Wellington had described them, had been recruited from villages and hamlets nearby. Wellington had later claimed  that it was "really wonderful that we should have made these men into the fine fellows they are." You consider the barrenness of that statement  now that tens of thousands of those fine fellows are dead. Many of those who survived were not the same as they were before the war, having succumbed to war exhaustion or madness, or worse.

The chill wind is making it hard to breathe, and you begin to feel light headed. Further south through the fields you can see the old farm cottage. 

An old rotting wooden post is here. Propped up against the post, standing to attention, is a lone scarecrow.

What would you like to do?

* * *

>help
Commands in interactive fiction are issued at the command prompt. You can go in any direction (e.g. "go north") and you issue commands in natural English (e.g. "take key" or "examine the tree"). You can re-print a room description by typing "look". Most common commands also have shortcuts, e.g. "n" will take you north, "x" will examine and "l" will look around. 

The intention with The Scarecrow is not to trick you - just try exploring and take in the world. Have fun!

>hit gate
Violence isn't the answer to this one.

You hear the harsh "caw" of a crow.

>ram gate
That's not a verb I recognise.

>x  mist
You can't see any such thing.

* * *

>s
(first opening the wooden gate)

The Barley Field
As you survey this rural wasteland, your mind drifts to the fields of battle in the aftermath of Waterloo. The casualties were horrendous, the victory far from glorious. Many of the soldiers who died that day, the "scum of the earth" as Wellington had described them, had been recruited from villages and hamlets nearby. Wellington had later reflected that it was "really wonderful that we should have made these men into the fine fellows they are." You consider the barrenness of that statement now that tens of thousands of those fine fellows are dead. Many of those who survived were not the same as they were before the war, having succumbed to war exhaustion, madness, or worse.

The stench of death is here, exemplified by the disease-ravaged crops left to abandonment in the surrounding fields. The chill wind makes it hard to breathe, and you begin to feel light headed. Further south through the fields you can see the old farm cottage. 

An old rotting wooden post is here. Propped up against the post, standing to attention, is a lone scarecrow.

>look around
You can't see any such thing.

What would you like to do?

>look
The Barley Field
You are standing in a field of barley. To the north is a wooden gate leading to a farm path. A cottage lies to the south.

An old rotting wooden post is here. Propped up against the post, standing to attention, is a lone scarecrow.

What would you like to do?

>l
The Barley Field
You are standing in a field of barley. To the north is a wooden gate leading to a farm path. A cottage lies to the south.

An old rotting wooden post is here. Propped up against the post, standing to attention, is a lone scarecrow.

What would you like to do?

* * *

>s
Front Of The Cottage
You approach the front of a large two storey cottage that is very familiar to you. A field of barley lies to the north. A path leads around the side of the cottage to the southwest. The cottage itself is directly south, the entrance blocked by a heavy oak door.

The crows continue to circle and caw all around, landing on the various protrusions around the cottage. 

You feel suddenly very sad, as if there is something at work in your soul which you do not understand.

>se
You follow garden path to the back of the cottage.

Back of the Cottage
You arrive in an ample-sized clearing of trampled barley which serves as a yard for the cottage.

You feel a slight twinge in your knee and wince in pain as you correct yourself. In that instant your thoughts turn to musket fire and the mayhem of battle, and to the sharp and sudden trauma below your right femur. 

And to falling.

You take a moment to gather your composure. You close your eyes and begin repeating to yourself "You are home. You are alive. " Eventually you open your eyes and breathe in the cold country air.

On the perimeter of the clearing is an old, broken plough. You can also see an ancient gnarled tree here.

* * *

>get key
As you pick up the key, your heart jolts - you hear four loud bangs coming from the front of the cottage, like metal knocking on wood. The sound echoes around the hills and then all is silent again.

>ne
You follow the garden path around to the front of the cottage.

As you make your way around the front of the cottage, you survey the area to see if you can identify the cause of the banging. Just as you are about to resign to having imagined the sound, you observe to your horror that the field to the north is now empty. 

The scarecrow has left his post!

You can vaguely make out that something has been nailed to the post in place of the scarecrow, flapping gently in the breeze.

Please press SPACE to continue.

Front Of The Cottage
You stand in front of a large two storey cottage . A field of barley lies to the North. A path leads around the side of the cottage to the southwest. The cottage itself is directly south, the entrance blocked by a heavy oak door. 

In the field to the north you can see something nailed to a post.  

You feel a cool breeze.

>unlock door
(with the rusty key)
You unlock the Front Door.

You feel a cool breeze.

>s
(first opening the Front Door)

The Lobby
As you enter the cottage through the heavy oak door, you disturb a number of crows who were sheltering inside. A violent fury of black feathers whip past your face as the crows exit the cottage to join their brothers in the fields. 

The lobby itself is bare and largely unfurnished, with wooden floorboards that continue south into a food preparation area, and west into a large living room. A few shelves adorn the wall and a table sits against the western wall. You feel nauseous and short of breath. Surfaces feel cold and damp to the touch.

On one of the shelves you see an old clock.

>x clock
The time reads eight minutes past three.

>n
Front Of The Cottage
You stand in front of a large two storey cottage . A field of barley lies to the North. A path leads around the side of the cottage to the southwest. The cottage itself is directly south, the entrance blocked by a heavy oak door. 

In the field to the north you can see something nailed to a post.  

You hear the harsh "caw" of a crow.

>n
The Barley Field
You are standing in a field of barley. To the north is a wooden gate leading to a farm path. A cottage lies to the south.

An old rotting wooden post is here. 

On the post is a note.

>n
The Farm Path
A wooden gate to the south leads to a field of barley. 

You see a small black cat sheltering under some nearby foliage.

>stroke cat
As you approach the cat, it flees into the undergrowth.

You feel a cool breeze.

>s
The Barley Field
You are standing in a field of barley. To the north is a wooden gate leading to a farm path. A cottage lies to the south.

An old rotting wooden post is here. 

On the post is a note.

>s
Front Of The Cottage
You stand in front of a large two storey cottage . A field of barley lies to the North. A path leads around the side of the cottage to the southwest. The cottage itself is directly south, the entrance blocked by a heavy oak door. 

In the field to the north you can see something nailed to a post.  

The small black cat from the farm path is here, washing himself among the barley.

>stroke cat
You kneel down and hold your arm out towards the cat, who responds by rubbing his face against your hand and purring loudly. He seems more comfortable around you now.

The cat heads north to the barley field.

the cat arrives from the north.

>z
Time passes.

The cat appears to be carrying a black feather in his mouth. He deposits the feather on the ground in front of you and stares up at you, seeking some kind of praise.

>l
Front Of The Cottage
You stand in front of a large two storey cottage . A field of barley lies to the North. A path leads around the side of the cottage to the southwest. The cottage itself is directly south, the entrance blocked by a heavy oak door. 

In the field to the north you can see something nailed to a post.  

You can see an a black feather. and the cat here.

* * *

>s
The kitchen
You enter a food preparation area towards the rear of the cottage. An iron-bake oven is here hung on a trammel over a fire pit. There is an old oak table in the centre of the room, and a cupboard against the far wall.

To the north is the lobby.

>open cupboard
That's not something you can open.

* * *

>s
The kitchen
You enter a food preparation area towards the rear of the cottage. An iron-bake oven is here hung on a trammel over a fire pit. There is an old oak table in the centre of the room, and a cupboard against the far wall.

To the north is the lobby.

>x cupboard
The cupboard is empty.

>open cupboard
That's already open.

>close cupboard
You close the cupboard.

>x cupboard
It's closed.

* * *

Front Of The Cottage
You stand in front of a large two storey cottage . A field of barley lies to the North. A path leads around the side of the cottage to the southwest. The cottage itself is directly south, the entrance blocked by a heavy oak door. 

In the field to the north you can see something nailed to a post.  

You feel a cool breeze.

>unlock door with key
You unlock the Front Door.

You hear the harsh "caw" of a crow.

>s
(first opening the Front Door)

The Lobby
As you enter the cottage through the heavy oak door, you disturb a number of crows who were sheltering inside. A violent fury of black feathers whip past your face as the crows exit the cottage to join their brothers in the fields. 

The lobby itself is bare and largely unfurnished, with wooden floorboards that continue south into a food preparation area, and west into a large living room. A few shelves adorn the wall and a table sits against the western wall. You feel nauseous and short of breath. Surfaces feel cold and damp to the touch.

On one of the shelves you see an old clock.

>w
The Living room
The living room, as with the rest of the cottage, is very sparsely furnished and ridden with dust and cobwebs. As you enter, your eye is caught by a crow at the window. The crow lets out a blood curdling screech and flies out of view.

You can see an old desk (on which is a piece of paper) here.

>x desk
The desk is long and coated in dust. Set into the rear of the desk is an inkwell. Stuck to the desk is a note.

>x note
You can't see any such thing.

* * *

>x desk
The desk is long and coated in dust. Set into the rear of the desk is an inkwell. Stuck to the desk is a note.

>read note
You can't see any such thing.

* * *

>w
The Living room
The living room, as with the rest of the cottage, is very sparsely furnished and ridden with dust and cobwebs. As you enter, your eye is caught by a crow at the window. The crow lets out a blood curdling screech and flies out of view.

You can see an old desk (on which is a piece of paper) here.

>write wellington
Woo.
That's not a verb I recognise.

* * *

>u
The Upstairs Hallway
Stairs lead down to the lobby. To the north is the bedroom, to the south is the bathroom.

>n
(first opening the Bedroom Door)
It seems to be locked.

* * *

>x plough
In addition to the rust and general disrepair of the plough, it also appears to have been damaged - the blades and handles are bent at awkward angles rendering the plough useless. It is as though somebody has purposefully impaired the plough from usage.

Hanging from the plough, you see a rusty key.

>n
The only entrance to the cottage is around the other side.

>get key
As you pick up the key, your heart jolts - you hear four loud bangs coming from the front of the cottage, like metal knocking on wood. The sound echoes around the hills and then all is silent again.

* * *

>n
The Farm Path
A wooden gate to the south leads to a field of barley. 

You see a small black cat sheltering under some nearby foliage.

>stroke cat
As you approach the cat, it flees into the undergrowth.

>s
The Barley Field
You are standing in a field of barley. To the north is a wooden gate leading to a farm path. A cottage lies to the south.

An old rotting wooden post is here. 

On the post is a note.

* * *

>s
Front Of The Cottage
You stand in front of a large two storey cottage . A field of barley lies to the North. A path leads around the side of the cottage to the southwest. The cottage itself is directly south, the entrance blocked by a heavy oak door. 

In the field to the north you can see something nailed to a post.  

The small black cat from the farm path is here, washing himself among the barley.

>stroke cat
You kneel down and hold your arm out towards the cat, who responds by rubbing his face against your hand and purring loudly. He seems more comfortable around you now.

The cat heads north to the barley field.

>unlock door with key
You unlock the Front Door.

>s
(first opening the Front Door)

The Lobby
As you enter the cottage through the heavy oak door, you disturb a number of crows who were sheltering inside. A violent fury of black feathers whip past your face as the crows exit the cottage to join their brothers in the fields. 

The lobby itself is bare and largely unfurnished, with wooden floorboards that continue south into a food preparation area, and west into a large living room. A few shelves adorn the wall and a table sits against the western wall. You feel nauseous and short of breath. Surfaces feel cold and damp to the touch.

On one of the shelves you see an old clock.

* * *

>w
The Living room
The living room, as with the rest of the cottage, is very sparsely furnished and ridden with dust and cobwebs. As you enter, your eye is caught by a crow at the window. The crow lets out a blood curdling screech and flies out of view.

You can see an old desk (on which is a piece of paper) here.

>e
The Lobby
You are in the lobby. The room is large and mostly empty, save for a few shelves. A kitchen is to the north, while to the west is a large living room.

On one of the shelves you see an old clock.

You can see the cat here.

The cat begins purring loudly.

The cat appears to be carrying a black feather in his mouth. He deposits the feather on the ground in front of you and stares up at you, seeking some kind of praise.

>get feather
Taken.

The cat yawns.

>x feather
Upon closer inspection you realise that the shaft is hollow and the end is sharpened to a point. The feather is in fact a quill pen.

The cat heads up to the upstairs hallway.

>w
The Living room
You are standing in the living room to the west of the cottage.

You can see an old desk (on which is a piece of paper) here.

>write george on paper
As you finish writing, you hear a "click" from upstairs.

>e
The Lobby
You are in the lobby. The room is large and mostly empty, save for a few shelves. A kitchen is to the north, while to the west is a large living room.

On one of the shelves you see an old clock.

You can see the cat here.

The cat sits in silence, staring at you.

>u
The Upstairs Hallway
You climb the creaky staircase and emerge in a small hallway. There are no windows up here, but the dim light from downstairs reveals an ominous looking door to the north. Light also emanates from the edges of the door, as if the door leads directly out into the open air.

As the creaking of the floorboards subsides, you realise that you can hear a slow, deep breathing. It appears to be coming from the other side of the door to the south.

>s
You can't go that way.

>n
(first opening the Ominous Door)

The Bedroom
You hold your breath as you enter the room, and quickly infer that this once served as the cottage's bed chamber. The room is as sparse and dusty as the rest of the cottage, the only furniture here is a ramshackle bed frame and a dressing table, on which is a dusty mirror.Whoever had occupied this room has clearly vacated, but dusty footprints indicate that someone was definitely here.

>x footprints
The footprints indicate that whoever was here had been pacing back and forth between the window and the dressing table. A cluster of footprints is also visible just on the inside of the door.

* * *

>x plough
In addition to the rust and general disrepair of the plough, it also appears to have been damaged - the blades and handles are bent at awkward angles rendering the plough useless. It is as though somebody has purposefully impaired the plough from usage.

Hanging from the plough, you see a rusty key.

>ne
You follow the garden path around to the front of the cottage.

Front Of The Cottage
You stand in front of a large two storey cottage . A field of barley lies to the North. A path leads around the side of the cottage to the southwest. The cottage itself is directly south, the entrance blocked by a heavy oak door.

>se
You follow garden path to the back of the cottage.

Back of the Cottage
You are standing at the rear of the cottage.

On the perimeter of the clearing is an old, broken plough. You can also see an ancient gnarled tree here.

On the plough is a rusty key.

>get key
As you pick up the key, your heart jolts - you hear four loud bangs coming from the front of the cottage, like metal knocking on wood. The sound echoes around the hills and then all is silent again.

* * *

>ne
You follow the garden path around to the front of the cottage.

As you make your way around the front of the cottage, you survey the area to see if you can identify the cause of the banging. Just as you are about to resign to having imagined the sound, you observe to your horror that the field to the north is now empty. 

The scarecrow has left his post!

You can vaguely make out that something has been nailed to the post in place of the scarecrow, flapping gently in the breeze.

Please press SPACE to continue.

Front Of The Cottage
You stand in front of a large two storey cottage . A field of barley lies to the North. A path leads around the side of the cottage to the southwest. The cottage itself is directly south, the entrance blocked by a heavy oak door. 

In the field to the north you can see something nailed to a post.  

You hear the harsh "caw" of a crow.

>n
The Barley Field
You are standing in a field of barley. To the north is a wooden gate leading to a farm path. A cottage lies to the south.

An old rotting wooden post is here. 

On the post is a note.

>n
The Farm Path
A wooden gate to the south leads to a field of barley. 

You see a small black cat sheltering under some nearby foliage.

The cat tilts his head to one side.

>stroke cat
As you approach the cat, it flees into the undergrowth.

You hear the harsh "caw" of a crow.

>s
The Barley Field
You are standing in a field of barley. To the north is a wooden gate leading to a farm path. A cottage lies to the south.

An old rotting wooden post is here. 

On the post is a note.

>s
Front Of The Cottage
You stand in front of a large two storey cottage . A field of barley lies to the North. A path leads around the side of the cottage to the southwest. The cottage itself is directly south, the entrance blocked by a heavy oak door. 

In the field to the north you can see something nailed to a post.  

The small black cat from the farm path is here, washing himself among the barley.

You feel a cool breeze.

>stroke cat
You kneel down and hold your arm out towards the cat, who responds by rubbing his face against your hand and purring loudly. He seems more comfortable around you now.

The cat heads north to the barley field.

>s
(first opening the Front Door)
You heave with all of your might but the heavy oak door will not budge. It appears to be locked.

* * *

>x clock
The time reads seventeen minutes past three.

the cat arrives from the north.

>e
You can't go that way.

The cat sits in silence, staring at you.

The cat appears to be carrying a black feather in his mouth. He deposits the feather on the ground in front of you and stares up at you, seeking some kind of praise.

>get feather
Taken.

>w
The Living room
The living room, as with the rest of the cottage, is very sparsely furnished and ridden with dust and cobwebs. As you enter, your eye is caught by a crow at the window. The crow lets out a blood curdling screech and flies out of view.

You can see an old desk (on which is a piece of paper) here.

>e
The Lobby
You are in the lobby. The room is large and mostly empty, save for a few shelves. A kitchen is to the north, while to the west is a large living room.

On one of the shelves you see an old clock.

You can see the cat here.

The cat meows.

>s
The kitchen
You enter a food preparation area towards the rear of the cottage. An iron-bake oven is here hung on a trammel over a fire pit. There is an old oak table in the centre of the room, and a cupboard against the far wall.

To the north is the lobby.

>n
The Lobby
You are in the lobby. The room is large and mostly empty, save for a few shelves. A kitchen is to the north, while to the west is a large living room.

On one of the shelves you see an old clock.

You can see the cat here.

The cat stares at the wall as if distracted by something, but there is nothing there.

>n
Front Of The Cottage
You stand in front of a large two storey cottage . A field of barley lies to the North. A path leads around the side of the cottage to the southwest. The cottage itself is directly south, the entrance blocked by a heavy oak door. 

In the field to the north you can see something nailed to a post.

>s
The Lobby
You are in the lobby. The room is large and mostly empty, save for a few shelves. A kitchen is to the north, while to the west is a large living room.

On one of the shelves you see an old clock.

You can see the cat here.

>w
The Living room
You are standing in the living room to the west of the cottage.

You can see an old desk (on which is a piece of paper) here.

>x paper
He hides away during the maelstrom, emerging only when he knows there is no hazard. He then wanders the fields, surveying the aftermath to amuse his curiosity. He greets the soldier as a friend, even though the two are strangers. The people still people warm to him, though he claws at their humility only to stroke his wretched ego.

He offers meagre trifles, but he is not to be trusted. His name is ____________________. 

At the foot of the letter is a dotted line, indicating that a word is missing.

* * *

Front Of The Cottage
You stand in front of a large two storey cottage . A field of barley lies to the North. A path leads around the side of the cottage to the southwest. The cottage itself is directly south, the entrance blocked by a heavy oak door. 

In the field to the north you can see something nailed to a post.  

You hear the harsh "caw" of a crow.

>unlock door with key
You unlock the Front Door.

* * *

>w
The Living room
The living room, as with the rest of the cottage, is very sparsely furnished and ridden with dust and cobwebs. As you enter, your eye is caught by a crow at the window. The crow lets out a blood curdling screech and flies out of view.

You can see an old desk (on which is a piece of paper) here.

>x paper
He hides away during the maelstrom, emerging only when he knows the landscape to be free from hazard. He wanders the fields, surveying the aftermath to amuse his curiosity. He greets the soldier as a friend, even though the two are strangers. The people still people warm to him, though he claws at their humility only to stroke his wretched ego.

He offers meagre trifles, but he is not to be trusted. Damn him, for he is named  . 

At the foot of the letter is a dotted line, indicating that a word is missing.

* * *

>u
The Upstairs Hallway
You climb the creaky staircase and emerge in a small hallway. There are no windows up here, but the dim light from downstairs reveals an ominous looking door to the south. Light also emanates from the edges of the door, as if the door leads directly out into the open air.

As the creaking of the floorboards subsides, you realise that you can hear a slow, deep breathing. It appears to be coming from the other side of the door to the south.

>open door
It seems to be locked.

>x door
A dusty timber door. Someone has etched the outline of a cat into the centre. Light emanates from the edges of the door. The gap at the bottom of the door looks wide enough to look under.

>look under gap
You put your head against the floor and peer under the crack at the base of the door. It is bright but you can make out two large shadows very close to the door. Are those feet?

>listen to door
You press your ear against the door, and can very clearly hear a deep, slow breathing on the other side. The breathing is very close, as if whoever is on the other side also has their ear against the door.

* * *

>n
The Farm Path
A wooden gate to the south leads to a field of barley. 

You see a small black cat sheltering under some nearby foliage.

The cat tilts his head to one side.

>stroke cat
As you approach the cat, it flees into the undergrowth.

>s
The Barley Field
You are standing in a field of barley. To the north is a wooden gate leading to a farm path. A cottage lies to the south.

An old rotting wooden post is here. Propped up against the post, standing to attention, is a lone scarecrow.

>s
Front Of The Cottage
You stand in front of a large two storey cottage . A field of barley lies to the North. A path leads around the side of the cottage to the southwest. The cottage itself is directly south, the entrance blocked by a heavy oak door.  

The small black cat from the farm path is here, washing himself among the barley.

>unlock door with key
You can't see any such thing.

>s
(first opening the Front Door)
You heave with all of your might but the heavy oak door will not budge. It appears to be locked.

The cat wags his tail violently from side to side.

>se
You follow garden path to the back of the cottage.

Back of the Cottage
You are standing at the rear of the cottage.

On the perimeter of the clearing is an old, broken plough. You can also see an ancient gnarled tree here.

On the plough is a rusty key.

* * *

>ne
You follow the garden path around to the front of the cottage.

As you make your way around the front of the cottage, you survey the area to see if you can identify the cause of the banging. Just as you are about to resign to having imagined the sound, you observe to your horror that the field to the north is now empty. 

The scarecrow has left his post!

You can vaguely make out that something has been nailed to the post in place of the scarecrow, flapping gently in the breeze.

Please press SPACE to continue.

Front Of The Cottage
You stand in front of a large two storey cottage . A field of barley lies to the North. A path leads around the side of the cottage to the southwest. The cottage itself is directly south, the entrance blocked by a heavy oak door. 

In the field to the north you can see something nailed to a post.  

The small black cat from the farm path is here, washing himself among the barley.

>unlock door with key
You unlock the Front Door.

* * *

>u
The Upstairs Hallway
Stairs lead down to the lobby. To the north is the bedroom, to the south is the bathroom.

>s
You can't go that way.

>n
(first opening the Bedroom Door)
It seems to be locked.

>x door
A dusty timber door. Someone has etched the outline of a cat into the centre.

>x outline
The outline of a cat, scored into the wood. It looks fairly fresh.

>d
The Lobby
You are in the lobby. The room is large and mostly empty, save for a few shelves. A kitchen is to the north, while to the west is a large living room.

On one of the shelves you see an old clock.

>w
The Living room
The living room, as with the rest of the cottage, is very sparsely furnished and ridden with dust and cobwebs. As you enter, your eye is caught by a crow at the window. The crow lets out a blood curdling screech and flies out of view.

You can see an old desk (on which is a piece of paper) here.

>e
The Lobby
You are in the lobby. The room is large and mostly empty, save for a few shelves. A kitchen is to the north, while to the west is a large living room.

On one of the shelves you see an old clock.

>s
The kitchen
You enter a food preparation area towards the rear of the cottage. An iron-bake oven is here hung on a trammel over a fire pit. There is an old oak table in the centre of the room, and a cupboard against the far wall.

To the north is the lobby.

>n
The Lobby
You are in the lobby. The room is large and mostly empty, save for a few shelves. A kitchen is to the north, while to the west is a large living room.

On one of the shelves you see an old clock.

>n
Front Of The Cottage
You stand in front of a large two storey cottage . A field of barley lies to the North. A path leads around the side of the cottage to the southwest. The cottage itself is directly south, the entrance blocked by a heavy oak door. 

In the field to the north you can see something nailed to a post.  

The small black cat from the farm path is here, washing himself among the barley.

>stroke cat
You kneel down and hold your arm out towards the cat, who responds by rubbing his face against your hand and purring loudly. He seems more comfortable around you now.

You feel a cool breeze.

>z
Time passes.

>n
The Barley Field
You are standing in a field of barley. To the north is a wooden gate leading to a farm path. A cottage lies to the south.

An old rotting wooden post is here. 

On the post is a note.

>s
Front Of The Cottage
You stand in front of a large two storey cottage . A field of barley lies to the North. A path leads around the side of the cottage to the southwest. The cottage itself is directly south, the entrance blocked by a heavy oak door. 

In the field to the north you can see something nailed to a post.  

You can see the cat here.

The cat meows.

>s
The Lobby
You are in the lobby. The room is large and mostly empty, save for a few shelves. A kitchen is to the north, while to the west is a large living room.

On one of the shelves you see an old clock.

>z
Time passes.

>n
Front Of The Cottage
You stand in front of a large two storey cottage . A field of barley lies to the North. A path leads around the side of the cottage to the southwest. The cottage itself is directly south, the entrance blocked by a heavy oak door. 

In the field to the north you can see something nailed to a post.

>i
You are carrying:
  a rusty key

>n
The Barley Field
You are standing in a field of barley. To the north is a wooden gate leading to a farm path. A cottage lies to the south.

An old rotting wooden post is here. 

On the post is a note.

You can also see the cat here.

The cat heads south to front of the cottage.

>s
Front Of The Cottage
You stand in front of a large two storey cottage . A field of barley lies to the North. A path leads around the side of the cottage to the southwest. The cottage itself is directly south, the entrance blocked by a heavy oak door. 

In the field to the north you can see something nailed to a post.  

You can see the cat here.

The cat heads southeast to back of the cottage.

>se
You follow garden path to the back of the cottage.

Back of the Cottage
You are standing at the rear of the cottage.

On the perimeter of the clearing is an old, broken plough. You can also see an ancient gnarled tree here.

You can see the cat here.

>x collar
The cats name is George.

>ne
You follow the garden path around to the front of the cottage.

Front Of The Cottage
You stand in front of a large two storey cottage . A field of barley lies to the North. A path leads around the side of the cottage to the southwest. The cottage itself is directly south, the entrance blocked by a heavy oak door. 

In the field to the north you can see something nailed to a post.

>z
Time passes.

* * *

>z
Time passes.

You hear the harsh "caw" of a crow.

>z
Time passes.

>s
The Lobby
You are in the lobby. The room is large and mostly empty, save for a few shelves. A kitchen is to the north, while to the west is a large living room.

On one of the shelves you see an old clock.

* * *

>z
Time passes.

>n
Front Of The Cottage
You stand in front of a large two storey cottage . A field of barley lies to the North. A path leads around the side of the cottage to the southwest. The cottage itself is directly south, the entrance blocked by a heavy oak door. 

In the field to the north you can see something nailed to a post.  

George arrives from the north.

>get feather
You can't see any such thing.

>n
The Barley Field
You are standing in a field of barley. To the north is a wooden gate leading to a farm path. A cottage lies to the south.

An old rotting wooden post is here. 

On the post is a note.

>n
The Farm Path
A wooden gate to the south leads to a field of barley.

>s
The Barley Field
You are standing in a field of barley. To the north is a wooden gate leading to a farm path. A cottage lies to the south.

An old rotting wooden post is here. 

On the post is a note.

You feel a cool breeze.

* * *

>x plough
In addition to the rust and general disrepair of the plough, it also appears to have been damaged - the blades and handles are bent at awkward angles rendering the plough useless. It is as though somebody has purposefully impaired the plough from usage.

Hanging from the plough, you see a rusty key.

I beg your pardon?

>get key
As you pick up the key, your heart jolts - you hear four loud bangs coming from the front of the cottage, like metal knocking on wood. The sound echoes around the hills and then all is silent again.

>n
The only entrance to the cottage is around the other side.

>n
The only entrance to the cottage is around the other side.

>ne
You follow the garden path around to the front of the cottage.

As you make your way around the front of the cottage, you survey the area to see if you can identify the cause of the banging. Just as you are about to resign to having imagined the sound, you observe to your horror that the field to the north is now empty. 

The scarecrow has left his post!

You can vaguely make out that something has been nailed to the post in place of the scarecrow, flapping gently in the breeze.

Please press SPACE to continue.

* * *

>stroke cat
As you approach the cat, it flees into the undergrowth.

>s
The Barley Field
You are standing in a field of barley. To the north is a wooden gate leading to a farm path. A cottage lies to the south.

An old rotting wooden post is here. 

On the post is a note.

You hear the harsh "caw" of a crow.

>s
Front Of The Cottage
You stand in front of a large two storey cottage . A field of barley lies to the North. A path leads around the side of the cottage to the southwest. The cottage itself is directly south, the entrance blocked by a heavy oak door. 

In the field to the north you can see something nailed to a post.  

The small black cat from the farm path is here, washing himself among the barley.

>stroke cat
You kneel down and hold your arm out towards the cat, who responds by rubbing his face against your hand and purring loudly. He seems more comfortable around you now.

>unlock door
(with the rusty key)
You unlock the Front Door.

The cat heads southeast to back of the cottage.

>s
(first opening the Front Door)

The Lobby
As you enter the cottage through the heavy oak door, you disturb a number of crows who were sheltering inside. A violent fury of black feathers whip past your face as the crows exit the cottage to join their brothers in the fields. 

The lobby itself is bare and largely unfurnished, with wooden floorboards that continue south into a food preparation area, and west into a large living room. A few shelves adorn the wall and a table sits against the western wall. You feel nauseous and short of breath. Surfaces feel cold and damp to the touch.

On one of the shelves you see an old clock.

>z
Time passes.

>z
Time passes.

the cat arrives from the north.

>z
Time passes.

The cat appears to be carrying a black feather in his mouth. He deposits the feather on the ground in front of you and stares up at you, seeking some kind of praise.

>praise cat
That's not a verb I recognise.

* * *

>x plouh
You can't see any such thing.

>x plough
In addition to the rust and general disrepair of the plough, it also appears to have been damaged - the blades and handles are bent at awkward angles rendering the plough useless. It is as though somebody has purposefully impaired the plough from usage.

Hanging from the plough, you see a rusty key.

* * *

Front Of The Cottage
You stand in front of a large two storey cottage . A field of barley lies to the North. A path leads around the side of the cottage to the southwest. The cottage itself is directly south, the entrance blocked by a heavy oak door. 

In the field to the north you can see something nailed to a post.

>unlock door with key
You unlock the Front Door.

* * *

>n
The only entrance to the cottage is around the other side.

>x plough
In addition to the rust and general disrepair of the plough, it also appears to have been damaged - the blades and handles are bent at awkward angles rendering the plough useless. It is as though somebody has purposefully impaired the plough from usage.

Hanging from the plough, you see a rusty key.

* * *

Front Of The Cottage
You stand in front of a large two storey cottage . A field of barley lies to the North. A path leads around the side of the cottage to the southwest. The cottage itself is directly south, the entrance blocked by a heavy oak door. 

In the field to the north you can see something nailed to a post.

>open door
You heave with all of your might but the heavy oak door will not budge. It appears to be locked.

You hear the harsh "caw" of a crow.

>unlock foor
You can't see any such thing.

>unlock door
(with the rusty key)
You unlock the Front Door.

* * *

>s
The kitchen
You enter a food preparation area towards the rear of the cottage. An iron-bake oven is here hung on a trammel over a fire pit. There is an old oak table in the centre of the room, and a cupboard against the far wall.

To the north is the lobby.

>x trammel
A metal trammel supporting a cast-iron Dutch oven.

>x oven
A thick-walled cast iron cooking pot. The surface of the pot is ashy and burnt-looking. The pot is empty.

>x cupboard
The dusty wooden cupboard is currently closed.

>x firepit
You can't see any such thing.

>x pit
A small stone fire pit. There is no fuel in the pit at the moment, just cold, ashy remnants. You pick up a handful of the ash and let it fall through your clenched fist. It is very cold to the touch.

* * *

>s
The fields of corn seem to go on forever and there would be little point in entering them. Front Of The Cottage is northwest.

>x plough
In addition to the rust and general disrepair of the plough, it also appears to have been damaged - the blades and handles are bent at awkward angles rendering the plough useless. It is as though somebody has purposefully impaired the plough from usage.

Hanging from the plough, you see a rusty key.

* * *

>n
The only entrance to the cottage is around the other side.

>nee
That's not a verb I recognise.

>ne
You follow the garden path around to the front of the cottage.

As you make your way around the front of the cottage, you survey the area to see if you can identify the cause of the banging. Just as you are about to resign to having imagined the sound, you observe to your horror that the field to the north is now empty. 

The scarecrow has left his post!

You can vaguely make out that something has been nailed to the post in place of the scarecrow, flapping gently in the breeze.

Please press SPACE to continue.

* * *

Front Of The Cottage
You stand in front of a large two storey cottage . A field of barley lies to the North. A path leads around the side of the cottage to the southwest. The cottage itself is directly south, the entrance blocked by a heavy oak door. 

In the field to the north you can see something nailed to a post.  

You hear the harsh "caw" of a crow.

>unlock door with key
You unlock the Front Door.

You feel a cool breeze.

>s
(first opening the Front Door)

>l
The Lobby
As you enter the cottage through the heavy oak door, you disturb a number of crows who were sheltering inside. A violent fury of black feathers whip past your face as the crows exit the cottage to join their brothers in the fields. 

The lobby itself is bare and largely unfurnished, with wooden floorboards that continue south into a food preparation area, and west into a large living room. A few shelves adorn the wall and a table sits against the western wall. You feel nauseous and short of breath. Surfaces feel cold and damp to the touch.

On one of the shelves you see an old clock.

>u
The Upstairs Hallway
Stairs lead down to the lobby. To the north is the bedroom, to the south is the bathroom.

* * *

>s
You can't go that way.

>n
The Bedroom
A door leads south into the upstairs hallway.

You can see a Bedroom Door here.

>s
(first opening the Bedroom Door)
You can't, since the Bedroom Door leads nowhere.

* * *

>u
The Upstairs Hallway
Stairs lead down to the lobby. To the north is the bedroom, to the south is the bathroom.

You can see a Bedroom Door here.

>s
You can't go that way.

>n
(first opening the Bedroom Door)

bedroom
A door leads south into the upstairs hallway.

You can see a Bedroom Door here.

>x door
You see nothing special about the Bedroom Door.

* * *

>s
Front Of The Cottage
You approach the front of a large two storey cottage that is very familiar to you. A field of barley lies to the north. A path leads around the side of the cottage to the southwest. The cottage itself is directly south, the entrance blocked by a heavy oak door.

The crows continue to circle and caw all around, landing on the various protrusions around the cottage. 

You feel suddenly very sad, as if there is something at work in your soul which you do not understand.

>s
(first opening the Front Door)
You heave with all of your might but the heavy oak door will not budge. It appears to be locked.

>se
You follow garden path to the back of the cottage.

Back of the Cottage
You arrive in an ample-sized clearing of trampled barley which serves as a yard for the cottage.

You feel a slight twinge in your knee and wince in pain as you correct yourself. In that instant your thoughts turn to musket fire and the mayhem of battle, and to the sharp and sudden trauma below your right femur. 

And to falling. And to the wet earth.

You take a moment to gather your composure. You close your eyes and begin repeating to yourself "You are home. You are alive. " Eventually you open your eyes and breathe in the cold country air.

On the perimeter of the clearing is an old, broken plough. You can also see an ancient gnarled tree here.

>x plough
In addition to the rust and general disrepair of the plough, it also appears to have been damaged - the blades and handles are bent at awkward angles rendering the plough useless. It is as though somebody has purposefully impaired the plough from usage.

Hanging from the plough, you see a rusty key.

* * *

>unlock door
(with the rusty key)
You unlock the Front Door.

>s
(first opening the Front Door)

The Lobby
As you enter the cottage through the heavy oak door, you disturb a number of crows who were sheltering inside. A violent fury of black feathers whip past your face as the crows exit the cottage to join their brothers in the fields. 

The lobby itself is bare and largely unfurnished, with wooden floorboards that continue south into a food preparation area, and west into a large living room. A few shelves adorn the wall and a table sits against the western wall. You feel nauseous and short of breath. Surfaces feel cold and damp to the touch.

On the shelf is a clock.

* * *

>ne
You follow the garden path around to the front of the cottage.

As you make your way around the front of the cottage, you survey the area to see if you can identify the cause of the banging. Just as you are about to resign to having imagined the sound, you observe to your horror that the field to the north is now empty. 

The scarecrow has left his post!

You can vaguely make out that something has been nailed to the post in place of the scarecrow, flapping gently in the breeze.

Please press SPACE to continue.

Front Of The Cottage
You stand in front of a large two storey cottage . A field of barley lies to the north. A path leads around the side of the cottage to the southwest. The cottage itself is directly south, the entrance blocked by a heavy oak door.

 

In the field to the north you can see something nailed to a post.  

You hear the harsh "caw" of a crow.

>unlock door
(with the rusty key)
You unlock the Front Door.

* * *

>s
The kitchen
You enter a food preparation area towards the rear of the cottage. An iron-bake oven is here hung on a trammel over a fire pit. There is an old oak table in the centre of the room, and a cupboard against the far wall.

To the north is the lobby.

>x table
You see nothing special about the old oak table.

Tucked into the woodwork beneath the table, you find a folded piece of paper. It appears to be a letter.

>l
The kitchen
You are in the food preparation area towards the rear of the cottage. An iron-bake oven is here hung on a trammel over a fire pit. There is an old oak table in the centre of the room, and a cupboard against the far wall.

To the north is the lobby.

You can see page one of a letter here.

>open cupboard
You open the cupboard.

>x cupboard
Whilst at some point the cupboard may have once been used to store various spices and root vegetables, it is presently bare save for a few cobwebs.

>x cobwebs
You can't see any such thing.

* * *

Front Of The Cottage
You stand in front of a large two storey cottage . A field of barley lies to the north. A path leads around the side of the cottage to the southwest. The cottage itself is directly south, the entrance blocked by a heavy oak door.

 

In the field to the north you can see something nailed to a post.  

You hear the harsh "caw" of a crow.

>s
(first opening the Front Door)
You heave with all of your might but the heavy oak door will not budge. It appears to be locked.

* * *

>w
The Living room
The living room, as with the rest of the cottage, is very sparsely furnished and ridden with dust and cobwebs.

As you enter, your eye is caught by a crow at the window. The crow lets out a blood curdling screech and flies out of view.

There is an old wooden desk here.

>l
The Living room
There is an old wooden desk here.

* * *

Front Of The Cottage
You stand in front of a large two storey cottage . A field of barley lies to the north. A path leads around the side of the cottage to the southwest. The cottage itself is directly south, the entrance blocked by a heavy oak door.

 

In the field to the north you can see something nailed to a post.  

You hear the harsh "caw" of a crow.

>unlock door with key
You unlock the Front Door.

You hear the harsh "caw" of a crow.

* * *

>w
The Living room
The living room, as with the rest of the cottage, is very sparsely furnished and ridden with dust and cobwebs. As you enter, your eye is caught by a crow at the window. The crow lets out a blood curdling screech and flies out of view.

You can see an old desk (on which is a piece of paper) here.

>write wellington
That's not a verb I recognise.

>Write
That's not a verb I recognise.

* * *

Front Of The Cottage
You stand in front of a large two storey cottage . A field of barley lies to the north. A path leads around the side of the cottage to the southwest. The cottage itself is directly south, the entrance blocked by a heavy oak door.

 

In the field to the north you can see something nailed to a post.  

You hear the harsh "caw" of a crow.

>n
The Barley Field
You are standing in a field of barley. To the north is a wooden gate leading to a farm path. A cottage lies to the south.

An old rotting wooden post is here. 

On the post is a note.

>x note
There is a message written on the note in what looks like charcoal. The author has used aggressive straight lines to etch out each letter. The message reads:

"Your place is in the fields"

>s
Front Of The Cottage
You stand in front of a large two storey cottage . A field of barley lies to the north. A path leads around the side of the cottage to the southwest. The cottage itself is directly south, the entrance blocked by a heavy oak door.

 

In the field to the north you can see something nailed to a post.  

You see a strange figure at one of the cottage's upper windows.

You feel a cool breeze.

* * *

>s
Front Of The Cottage
You approach the front of a large two storey cottage that is very familiar to you. A field of barley lies to the north. A path leads around the side of the cottage to the southwest. The cottage itself is directly south, the entrance blocked by a heavy oak door.

The crows continue to circle and caw all around, landing on the various protrusions around the cottage. 

You feel suddenly very sad, as if there is something at work in your soul which you do not understand.

>sw
You follow garden path to the back of the cottage.

Back of the Cottage
You arrive in an ample-sized clearing of trampled barley which serves as a yard for the cottage.

You feel a slight twinge in your knee and wince in pain as you correct yourself. In that instant your thoughts turn to musket fire and the mayhem of battle, and to the sharp and sudden trauma below your right femur. 

And to falling.

You take a moment to gather your composure. You close your eyes and begin repeating to yourself "You are home. You are alive. " Eventually you open your eyes and breathe in the cold country air.

On the perimeter of the clearing is an old, broken plough. You can also see an ancient gnarled tree here.

>x plough
In addition to the rust and general disrepair of the plough, it also appears to have been damaged - the blades and handles are bent at awkward angles rendering the plough useless. It is as though somebody has purposefully impaired the plough from usage.

Hanging from the plough, you see a rusty key.

* * *

Front Of The Cottage
You stand in front of a large two storey cottage . A field of barley lies to the North. A path leads around the side of the cottage to the southwest. The cottage itself is directly south, the entrance blocked by a heavy oak door. 

In the field to the north you can see something nailed to a post.

>unlock door
(with the rusty key)
You unlock the Front Door.

You feel a cool breeze.

* * *

>w
The Living room
The living room, as with the rest of the cottage, is very sparsely furnished and ridden with dust and cobwebs. As you enter, your eye is caught by a crow at the window. The crow lets out a blood curdling screech and flies out of view.

You can see an an old desk (on which is a candle) here.

* * *

>s
Front Of The Cottage
You approach the front of a large two storey cottage that is very familiar to you. A field of barley lies to the north. A path leads around the side of the cottage to the southwest. The cottage itself is directly south, the entrance blocked by a heavy oak door.

The crows continue to circle and caw all around, landing on the various protrusions around the cottage. 

You feel suddenly very sad, as if there is something at work in your soul which you do not understand.

>n
The Barley Field
You are standing in a field of barley. To the north is a wooden gate leading to a farm path. A cottage lies to the south.

An old rotting wooden post is here. Propped up against the post, standing to attention, is a lone scarecrow.

>n
The Farm Path
A wooden gate to the south leads to a field of barley. 

You see a small black cat sheltering under some nearby foliage.

* * *

>s
Front Of The Cottage
You stand in front of a large two storey cottage . A field of barley lies to the North. A path leads around the side of the cottage to the southwest. The cottage itself is directly south, the entrance blocked by a heavy oak door.  

The small black cat from the farm path is here, washing himself among the barley.

>stroke cat
You kneel down and hold your arm out towards the cat, who responds by rubbing his face against your hand and purring loudly. He seems more comfortable around you now.

The cat yawns.

>se
You follow garden path to the back of the cottage.

Back of the Cottage
You arrive in an ample-sized clearing of trampled barley which serves as a yard for the cottage.

You feel a slight twinge in your knee and wince in pain as you correct yourself. In that instant your thoughts turn to musket fire and the mayhem of battle, and to the sharp and sudden trauma below your right femur. 

And to falling.

You take a moment to gather your composure. You close your eyes and begin repeating to yourself "You are home. You are alive. " Eventually you open your eyes and breathe in the cold country air.

On the perimeter of the clearing is an old, broken plough. You can also see an ancient gnarled tree here.

* * *

Front Of The Cottage
You stand in front of a large two storey cottage . A field of barley lies to the North. A path leads around the side of the cottage to the southwest. The cottage itself is directly south, the entrance blocked by a heavy oak door. 

In the field to the north you can see something nailed to a post.

>n
The Barley Field
You are standing in a field of barley. To the north is a wooden gate leading to a farm path. A cottage lies to the south.

An old rotting wooden post is here. 

On the post is a note.

You can also see the cat here.

The cat heads south to front of the cottage.

>x note
There is a message inscribed onto the note in what looks like charcoal. The author has used aggressive straight lines to etch out each letter. The message reads:

"Your place is in the fields"

>s
Front Of The Cottage
You stand in front of a large two storey cottage . A field of barley lies to the North. A path leads around the side of the cottage to the southwest. The cottage itself is directly south, the entrance blocked by a heavy oak door. 

In the field to the north you can see something nailed to a post. 

You see a strange figure at one of the cottage's upper windows. 

You can see the cat here.

The cat arches his shoulders and attempts to sneak up on a nearby crow, but it flies away moments before he pounces.

>x figure
You see a strange figure at the window.

As your eyes begin to focus more clearly, the figure fades from view. Was it even there in the first place?

The cat heads southeast to back of the cottage.

>listen to door
You hear nothing unexpected.

>listen closely to door
I only understood you as far as wanting to listen.

>unlock door with key
You unlock the Front Door.

>s
(first opening the Front Door)

The Lobby
As you enter the cottage through the heavy oak door, you disturb a number of crows who were sheltering inside. A violent fury of black feathers whip past your face as the crows exit the cottage to join their brothers in the fields. 

The lobby itself is bare and largely unfurnished, with wooden floorboards that continue south into a food preparation area, and west into a large living room. A few shelves adorn the wall and a table sits against the western wall. You feel nauseous and short of breath. Surfaces feel cold and damp to the touch.

On one of the shelves you see an old clock.

the cat arrives from the north.

>w
The Living room
The living room, as with the rest of the cottage, is very sparsely furnished and ridden with dust and cobwebs. As you enter, your eye is caught by a crow at the window. The crow lets out a blood curdling screech and flies out of view.

You can see an old desk (on which is a piece of paper) here.

the cat arrives from the east.

>x desk
The desk is long and coated in dust. Set into the rear of the desk is an inkwell. On to the desk is a note. The not appears to be stuck to the desk with some kind of adhesive.

On the old desk is a piece of paper.

The cat stares at the wall as if distracted by something, but there is nothing there.

The cat appears to be carrying a black feather in his mouth. He deposits the feather on the ground in front of you and stares up at you, seeking some kind of praise.

>get feather
Taken.

>x feather
Upon closer inspection you realise that the shaft is hollow and the end is sharpened to a point. The feather is in fact a quill pen.

The cat heads east to the lobby.

>write george on paper
As you finish writing, you hear a "click" from upstairs.

>e
The Lobby
You are in the lobby. The room is large and mostly empty, save for a few shelves. A kitchen is to the north, while to the west is a large living room.

On one of the shelves you see an old clock.

You can see the cat here.

>u
The Upstairs Hallway
Stairs lead down to the lobby. To the north is the bedroom, to the south is the bathroom.

>n
(first opening the Bedroom Door)

Bedroom
A door leads south into the upstairs hallway.

* * *

>s
Front Of The Cottage
You stand in front of a large two storey cottage . A field of barley lies to the North. A path leads around the side of the cottage to the southwest. The cottage itself is directly south, the entrance blocked by a heavy oak door.  

The small black cat from the farm path is here, washing himself among the barley.

>se
You follow garden path to the back of the cottage.

Back of the Cottage
You arrive in an ample-sized clearing of trampled barley which serves as a yard for the cottage.

You feel a slight twinge in your knee and wince in pain as you correct yourself. In that instant your thoughts turn to musket fire and the mayhem of battle, and to the sharp and sudden trauma below your right femur. 

And to falling.

You take a moment to gather your composure. You close your eyes and begin repeating to yourself "You are home. You are alive. " Eventually you open your eyes and breathe in the cold country air.

On the perimeter of the clearing is an old, broken plough. You can also see an ancient gnarled tree here.

* * *

Front Of The Cottage
You stand in front of a large two storey cottage . A field of barley lies to the North. A path leads around the side of the cottage to the southwest. The cottage itself is directly south, the entrance blocked by a heavy oak door. 

In the field to the north you can see something nailed to a post.  

The small black cat from the farm path is here, washing himself among the barley.

>s
(first opening the Front Door)
You heave with all of your might but the heavy oak door will not budge. It appears to be locked.

The cat tilts his head to one side.

>stroke cat
You kneel down and hold your arm out towards the cat, who responds by rubbing his face against your hand and purring loudly. He seems more comfortable around you now.

>unlock door with key
You unlock the Front Door.

* * *

>e
You can't go that way.

>w
The Living room
The living room, as with the rest of the cottage, is very sparsely furnished and ridden with dust and cobwebs. As you enter, your eye is caught by a crow at the window. The crow lets out a blood curdling screech and flies out of view.

You can see an old desk (on which is a piece of paper) here.

* * *

>s
The kitchen
You enter a food preparation area towards the rear of the cottage. An iron-bake oven is here hung on a trammel over a fire pit. There is an old oak table in the centre of the room, and a cupboard against the far wall.

To the north is the lobby.

>z
Time passes.

>n
The Lobby
You are in the lobby. The room is large and mostly empty, save for a few shelves. A kitchen is to the north, while to the west is a large living room.

On one of the shelves you see an old clock.

>n
Front Of The Cottage
You stand in front of a large two storey cottage . A field of barley lies to the North. A path leads around the side of the cottage to the southwest. The cottage itself is directly south, the entrance blocked by a heavy oak door. 

In the field to the north you can see something nailed to a post.

>s
The Lobby
You are in the lobby. The room is large and mostly empty, save for a few shelves. A kitchen is to the north, while to the west is a large living room.

On one of the shelves you see an old clock.

>s
The kitchen
You are in the food preparation area towards the rear of the cottage. An iron-bake oven is here hung on a trammel over a fire pit. There is an old oak table in the centre of the room, and a cupboard against the far wall.

To the north is the lobby.

>n
The Lobby
You are in the lobby. The room is large and mostly empty, save for a few shelves. A kitchen is to the north, while to the west is a large living room.

On one of the shelves you see an old clock.

>z
Time passes.

* * *

>n
Front Of The Cottage
You stand in front of a large two storey cottage . A field of barley lies to the North. A path leads around the side of the cottage to the southwest. The cottage itself is directly south, the entrance blocked by a heavy oak door. 

In the field to the north you can see something nailed to a post.

>n
The Barley Field
You are standing in a field of barley. To the north is a wooden gate leading to a farm path. A cottage lies to the south.

An old rotting wooden post is here. 

On the post is a note.

You can also see the cat here.

The cat heads south to front of the cottage.

>s
Front Of The Cottage
You stand in front of a large two storey cottage . A field of barley lies to the North. A path leads around the side of the cottage to the southwest. The cottage itself is directly south, the entrance blocked by a heavy oak door. 

In the field to the north you can see something nailed to a post.  

You can see the cat here.

>x cat
A small black cat with wide, yellow eyes. The cat is wearing a silver collar.

The cat heads southeast to back of the cottage.

* * *

>se
The fields of corn seem to go on forever and there would be little point in entering them. The Farm Path is north. Front Of The Cottage is south.

>s
Front Of The Cottage
You approach the front of a large two storey cottage that is very familiar to you. A field of barley lies to the North. A path leads around the side of the cottage to the southwest. The cottage itself is directly south, the entrance blocked by a heavy oak door.

* * *

Front Of The Cottage
You stand in front of a large two storey cottage . A field of barley lies to the North. A path leads around the side of the cottage to the southwest. The cottage itself is directly south, the entrance blocked by a heavy oak door. 

In the field to the north you can see something nailed to a post.

>unlock door
(with the rusty key)
You unlock the Front Door.

You hear the harsh "caw" of a crow.

>x clock
You can't see any such thing.

>s
(first opening the Front Door)

The Lobby
As you enter the cottage through the heavy oak door, you disturb a number of crows who were sheltering inside. A violent fury of black feathers whip past your face as the crows exit the cottage to join their brothers in the fields. 

The lobby itself is bare and largely unfurnished, with wooden floorboards that continue south into a food preparation area, and west into a large living room. A few shelves adorn the wall and a table sits against the western wall. You feel nauseous and short of breath. Surfaces feel cold and damp to the touch.

On one of the shelves you see an old clock.

>x clock
The time reads nine minutes past three.

>n
    *** End of demo! ***

In that game you scored 0 out of a possible 0, in 11 turns.

Would you like to RESTART, RESTORE a saved game, QUIT or UNDO the last command?

* * *

Front Of The Cottage
You stand in front of a large two storey cottage . A field of barley lies to the North. A path leads around the side of the cottage to the southwest. The cottage itself is directly south, the entrance blocked by a heavy oak door. 

In the field to the north you can see something nailed to a post.

>ne
The fields of corn seem to go on forever and there would be little point in entering them. The Barley Field is north. The Lobby is south. Back of the Cottage is southeast. 

You hear the harsh "caw" of a crow.

>unlock door
(with the rusty key)
You unlock the Front Door.

>enter cottage
(first opening the Front Door)

The Lobby
As you enter the cottage through the heavy oak door, you disturb a number of crows who were sheltering inside. A violent fury of black feathers whip past your face as the crows exit the cottage to join their brothers in the fields. 

The lobby itself is bare and largely unfurnished, with wooden floorboards that continue south into a food preparation area, and west into a large living room. A few shelves adorn the wall and a table sits against the western wall. You feel nauseous and short of breath. Surfaces feel cold and damp to the touch.

On one of the shelves you see an old clock.

>u
The Upstairs Hallway
You climb the creaky staircase and emerge in a small hallway. There are no windows up here, but the dim light from downstairs reveals an ominous looking door to the south. Light also emanates from the edges of the door, as if the door leads directly out into the open air.

As the creaking of the floorboards subsides, you realise that you can hear a slow, deep breathing. It appears to be coming from the other side of the door to the south.

* * *

>x door
A dusty timber door. Someone has etched the outline of a cat into the centre. Light emanates from the edges of the door. The gap at the bottom of the door looks wide enough to look under.

>look under door
You put your head against the floor and peer under the crack at the base of the door. It is bright but you can make out two large shadows very close to the door. Are those feet? You can still hear the breathing, you consider whether listening to the door might help you identify the sound more clearly.

>listen to door
You press your ear against the door, and can very clearly hear a deep, slow breathing on the other side. The breathing is very close, as if whoever is on the other side also has their ear against the door. Perhaps you can get their attention somehow?

>knock on door
You knock three times on the door, the sound echoes around the cottage and then all is quiet again. You realise that the breathing on the other side appears to have stopped. Your contemplation is interrupted as suddenly you hear three very loud bangs from the other side of the door, as if someone is thumping with all of their might on the door. The sound causes the whole cottage to vibrate. After a few moments, the slow breathing resumes.

You conclude that the only way you are getting through this door is to figure out how to unlock it. Perhaps you should explore the rest of the cottage for clues?

>s
You can't go that way.

>l
The Upstairs Hallway
You are standing in the upstairs hallway of the cottage. The only exits are back downstairs to the lobby and south through an ominous door. Stairs lead down to the lobby. To the north is the bedroom.

* * *

>say hello to scarecrow
You begin to converse with the scarecrow for a few moments, but eventually snap to the realisation that you are talking to yourself.

>s
Front Of The Cottage
You approach the front of a large two storey cottage that is very familiar to you. A field of barley lies to the North. A path leads around the side of the cottage to the southwest. The cottage itself is directly south, the entrance blocked by a heavy oak door.  

You feel a cool breeze.

>se
You follow garden path to the back of the cottage.

Back of the Cottage
You arrive in an ample-sized clearing of trampled barley which serves as a yard for the cottage.

You feel a slight twinge in your knee and wince in pain as you correct yourself. In that instant your thoughts turn to musket fire and the mayhem of battle, and to the sharp and sudden trauma below your right femur. 

And to falling.

You take a moment to gather your composure. You close your eyes and begin repeating to yourself "You are home. You are alive. " Eventually you open your eyes and breathe in the cold country air.

On the perimeter of the clearing is an old, broken plough. You can also see an ancient gnarled tree here.

* * *

Front Of The Cottage
You stand in front of a large two storey cottage . A field of barley lies to the North. A path leads around the side of the cottage to the southwest. The cottage itself is directly south, the entrance blocked by a heavy oak door. 

In the field to the north you can see something nailed to a post.

>n
The Barley Field
You are standing in a field of barley. To the north is a wooden gate leading to a farm path. A cottage lies to the south.

An old rotting wooden post is here. 

On the post is a note.

You hear the harsh "caw" of a crow.

>x note
There is a message inscribed onto the note in what looks like charcoal. The author has used aggressive straight lines to etch out each letter. The message reads:

"Your place is in the fields"

>n
The Farm Path
A wooden gate to the south leads to a field of barley. 

You see a small black cat sheltering under some nearby foliage.

* * *

>s
The Barley Field
You are standing in a field of barley. To the north is a wooden gate leading to a farm path. A cottage lies to the south.

An old rotting wooden post is here. 

On the post is a note.

>s
Front Of The Cottage
You stand in front of a large two storey cottage . A field of barley lies to the North. A path leads around the side of the cottage to the southwest. The cottage itself is directly south, the entrance blocked by a heavy oak door. 

In the field to the north you can see something nailed to a post. 

You see a strange figure at one of the cottage's upper windows. 

The small black cat from the farm path is here, washing himself among the barley.

You feel a cool breeze.

The cat tilts his head to one side.

>x strange figure
You see a strange figure at the window.

As your eyes begin to focus more clearly, the figure fades from view. Was it even there in the first place?

The cat wags his tail violently from side to side.

>stroke cat
You kneel down and hold your arm out towards the cat, who responds by rubbing his face against your hand and purring loudly. He seems more comfortable around you now.

You hear the harsh "caw" of a crow.

>unlock door with key
You unlock the Front Door.

You feel a cool breeze.

The cat heads north to the barley field.

>s
(first opening the Front Door)

The Lobby
As you enter the cottage through the heavy oak door, you disturb a number of crows who were sheltering inside. A violent fury of black feathers whip past your face as the crows exit the cottage to join their brothers in the fields. 

The lobby itself is bare and largely unfurnished, with wooden floorboards that continue south into a food preparation area, and west into a large living room. A few shelves adorn the wall and a table sits against the western wall. You feel nauseous and short of breath. Surfaces feel cold and damp to the touch.

On one of the shelves you see an old clock.

* * *

>n
(first opening the Bedroom Door)
It seems to be locked.

>d
The Lobby
You are in the lobby. The room is large and mostly empty, save for a few shelves. A kitchen is to the north, while to the west is a large living room.

On one of the shelves you see an old clock.

You can see the cat here.

The cat heads west to the living room.

the cat arrives from the west.

>w
The Living room
The living room, as with the rest of the cottage, is very sparsely furnished and ridden with dust and cobwebs. As you enter, your eye is caught by a crow at the window. The crow lets out a blood curdling screech and flies out of view.

You can see an old desk (on which is a piece of paper) here.

the cat arrives from the east.

>x desk
The desk is long and coated in dust. Set into the rear of the desk is an inkwell. On to the desk is a note. The not appears to be stuck to the desk with some kind of adhesive.

On the old desk is a piece of paper.

The cat appears to be carrying a black feather in his mouth. He deposits the feather on the ground in front of you and stares up at you, seeking some kind of praise.

>x piece of paper
You lean over the desk to read the message:

He hides away during the maelstrom, emerging only when he knows the landscape to be free from hazard. He wanders the fields, surveying the aftermath to amuse his curiosity. He greets the soldier as a friend, even though the two are strangers. The people still people warm to him, though he claws at their humility only to stroke his wretched ego.

He offers meagre trifles, but he is not to be trusted. Damn him, he who is named _________________________. 

At the foot of the letter is a dotted line, indicating that a word is missing.

The cat heads east to the lobby.

>l
The Living room
You are standing in the living room to the west of the cottage.

You can see a black feather and an old desk (on which is a piece of paper) here.

>get feather
Taken.

>l
The Living room
You are standing in the living room to the west of the cottage.

You can see an old desk (on which is a piece of paper) here.

>write george on paper
You do not have anything to write with.

>write george onto paper
You should try writing something ON something...

* * *

>n
The Farm Path
A wooden gate to the south leads to a field of barley. 

You see a small black cat sheltering under some nearby foliage.

* * *

>stroke cat
As you approach the cat, it flees into the undergrowth.

>s
The Barley Field
You are standing in a field of barley. To the north is a wooden gate leading to a farm path. A cottage lies to the south.

An old rotting wooden post is here. Propped up against the post, standing to attention, is a lone scarecrow.

You feel a cool breeze.

>s
Front Of The Cottage
You approach the front of a large two storey cottage that is very familiar to you. A field of barley lies to the North. A path leads around the side of the cottage to the southwest. The cottage itself is directly south, the entrance blocked by a heavy oak door.   

The small black cat from the farm path is here, washing himself among the barley. 

The cat tilts his head to one side.

>stroke cat
You kneel down and hold your arm out towards the cat, who responds by rubbing his face against your hand and purring loudly. He seems more comfortable around you now.

>se
You follow garden path to the back of the cottage.

Back of the Cottage
You arrive in an ample-sized clearing of trampled barley which serves as a yard for the cottage.

You feel a slight twinge in your knee and wince in pain as you correct yourself. In that instant your thoughts turn to musket fire and the mayhem of battle, and to the sharp and sudden trauma below your right femur. 

And to falling.

You take a moment to gather your composure. You close your eyes and begin repeating to yourself "You are home. You are alive. " Eventually you open your eyes and breathe in the cold country air.

On the perimeter of the clearing is an old, broken plough. You can also see an ancient gnarled tree here.

* * *

>x plough
In addition to the rust and general disrepair of the plough, it also appears to have been damaged - the blades and handles are bent at awkward angles rendering the plough useless. It is as though somebody has purposefully impaired the plough from usage.

Hanging from the plough, you see a rusty key.

>get key
As you pick up the key, your heart jolts - you hear four loud bangs coming from the front of the cottage, like metal knocking on wood. The sound echoes around the hills and then all is silent again.

The cat arrives from the northwest.

>ne
You follow the garden path around to the front of the cottage.

As you make your way around the front of the cottage, you survey the area to see if you can identify the cause of the banging. Just as you are about to resign to having imagined the sound, you observe to your horror that the field to the north is now empty. 

The scarecrow has left his post!

You can vaguely make out that something has been nailed to the post in place of the scarecrow, flapping gently in the breeze.

Please press SPACE to continue.

Front Of The Cottage
You stand in front of a large two storey cottage . A field of barley lies to the North. A path leads around the side of the cottage to the southwest. The cottage itself is directly south, the entrance blocked by a heavy oak door. 

In the field to the north you can see something nailed to a post.    

The cat arrives from the southeast.

>unlock door with key
You unlock the Front Door.

You hear the harsh "caw" of a crow.

* * *

>u
The Upstairs Hallway
You climb the creaky staircase and emerge in a small hallway. There are no windows up here, but the dim light from downstairs reveals an ominous looking door to the north. Light also emanates from the edges of the door, as if the door leads directly out into the open air.

As the creaking of the floorboards subsides, you realise that you can hear a slow, deep breathing. It appears to be coming from the other side of the door to the south.

>l
The Upstairs Hallway
You are standing in the upstairs hallway of the cottage. The only exits are back downstairs and north towards a room at the front of the cottage.

>n
(first opening the Ominous Door)
It seems to be locked.

>d
The Lobby
You are in the lobby. The room is large and mostly empty, save for a few shelves. A kitchen is to the north, while to the west is a large living room.

On one of the shelves you see an old clock.

>s
The kitchen
You enter a food preparation area towards the rear of the cottage. An iron-bake oven is here hung on a trammel over a fire pit. There is an old oak table in the centre of the room, and a cupboard against the far wall.

To the north is the lobby.

>n
The Lobby
You are in the lobby. The room is large and mostly empty, save for a few shelves. A kitchen is to the north, while to the west is a large living room.

On one of the shelves you see an old clock.

You can see the cat here.

The cat heads up to the upstairs hallway.

the cat arrives from above.

>w
The Living room
The living room, as with the rest of the cottage, is very sparsely furnished and ridden with dust and cobwebs. As you enter, your eye is caught by a crow at the window. The crow lets out a blood curdling screech and flies out of view.

You can see an old desk (on which is a piece of paper) here.

the cat arrives from the east.

>x desk
The desk is long and coated in dust. Set into the rear of the desk is an inkwell. On to the desk is a note. The not appears to be stuck to the desk with some kind of adhesive.

On the old desk is a piece of paper.

The cat heads east to the lobby.

the cat arrives from the east.

>z
Time passes.

The cat meows.

The cat appears to be carrying a black feather in his mouth. He deposits the feather on the ground in front of you and stares up at you, seeking some kind of praise.

>get feather
Taken.

>x feather
Upon closer inspection you realise that the shaft is hollow and the end is sharpened to a point. The feather is in fact a quill pen.

>write george on paper
As you finish writing, you hear a "click" from upstairs.

The cat heads east to the lobby.

>follow cat
(heading east)

The Lobby
You are in the lobby. The room is large and mostly empty, save for a few shelves. A kitchen is to the north, while to the west is a large living room.

On one of the shelves you see an old clock.

You can see the cat here.

The cat yawns.

>u
The Upstairs Hallway
You are standing in the upstairs hallway of the cottage. The only exits are back downstairs and north towards a room at the front of the cottage.

>x door
A dusty timber door. Someone has etched the outline of a cat into the centre. Light emanates from the edges of the door. The gap at the bottom of the door looks wide enough to see under.

>open door
You open the Ominous Door.

>s
You can't go that way.

>n
bedroom
You hold your breath as you enter the room, and quickly infer that this once served as the cottage's bed chamber. The room is as sparse and dusty as the rest of the cottage, the only furniture here is a ramshackle bed frame and a dressing table, on which is a dusty mirror.

>l
bedroom
The bedroom is as sparse and dusty as the rest of the cottage, the only furniture here is a ramshackle bed frame and a dressing table, on which is a dusty mirror.

>x bed
The frame is old and dilapidated. The bed is missing a mattress.

>x dressing table
The dressing table is old and worn.

Wedged into the woodwork beneath the table, you find a folded piece of paper. It appears to be a letter.

* * *

Front Of The Cottage
You stand in front of a large two storey cottage . A field of barley lies to the North. A path leads around the side of the cottage to the southwest. The cottage itself is directly south, the entrance blocked by a heavy oak door. 

In the field to the north you can see something nailed to a post.    

The cat arrives from the southeast.

>n
The Barley Field
You are standing in a field of barley. To the north is a wooden gate leading to a farm path. A cottage lies to the south.

An old rotting wooden post is here. 

On the post is a note.

You hear the harsh "caw" of a crow.

The cat arrives from the south.

>x note
There is a message inscribed onto the note in what looks like charcoal. The author has used aggressive straight lines to etch out each letter. The message reads:

"Your place is in the fields"

The cat heads south to front of the cottage.

>s
Front Of The Cottage
You stand in front of a large two storey cottage . A field of barley lies to the North. A path leads around the side of the cottage to the southwest. The cottage itself is directly south, the entrance blocked by a heavy oak door. 

In the field to the north you can see something nailed to a post.  

You see a strange figure at one of the cottage's upper windows.  

You can see the cat here.

The cat heads north to the barley field.

>unlock door with key
You unlock the Front Door.

* * *

>w
The Living room
The living room, as with the rest of the cottage, is very sparsely furnished and ridden with dust and cobwebs. As you enter, your eye is caught by a crow at the window. The crow lets out a blood curdling screech and flies out of view.

You can see an old desk (on which is a piece of paper) here.

>z
Time passes.

>z
Time passes.

The cat arrives from the east.

The cat appears to be carrying a black feather in his mouth. He deposits the feather on the ground in front of you and stares up at you, seeking some kind of praise.

>get feather
Taken.

The cat begins purring loudly.

>x feather
Upon closer inspection you realise that the shaft is hollow and the end is sharpened to a point. The feather is in fact a quill pen.

The cat heads east to the lobby.

>write george on paper
As you finish writing, you hear a "click" from upstairs, as if a door was being unlocked.

>e
The Lobby
You are in the lobby. The room is large and mostly empty, save for a few shelves. A kitchen is to the north, while to the west is a large living room.

On one of the shelves you see an old clock.

You can see the cat here.

The cat heads up to the upstairs hallway.

>u
The Upstairs Hallway
You climb the creaky staircase and emerge in a small hallway. There are no windows up here, but the dim light from downstairs reveals an ominous looking door to the north. Light also emanates from the edges of the door, as if the door leads directly out into the open air.

As the creaking of the floorboards subsides, you realise that you can hear a slow, deep breathing. It appears to be coming from the other side of the door to the north.

You can see the cat here.

>x collar
The cats name is George.

George sits in silence, staring at you.

>unlock door
What do you want to unlock the Ominous Door with?

I beg your pardon?

>key
That's unlocked at the moment.

George begins purring loudly.

>s
You can't go that way.

George heads down to the lobby.

>n
(first opening the Ominous Door)

The Bedroom
You hold your breath as you enter the room, and you find yourself alone. You infer from the furniture that this room had once served as the cottage's bed chamber. The room is as sparse and dusty as the rest of the cottage, a ramshackle bed frame is situated against the east wall next to an old dressing table, on which is a dusty mirror. Light pours through a large window on the far wall.

Whoever had occupied this room has clearly vacated - only a set of dusty footprints indicate that anyone was ever here.

>x window
Through the window you can see the barley field, and the pole where the scarecrow once stood.

>clean mirror
You wipe away the dust from the mirror.

>x mirror
As you stare into the glass of the mirror, you realise to your horror that visage staring back at you is that of a scarecrow. You jolt backwards only to see the scarecrow jolt identically. You bring your right hand up to your face, and once again your reflection reciprocates. You contemplate in disbelief that you are a mere facsimile of a man, a thing of straw and cloth. You stumble backwards and use the bed frame to support yourself.

As you correct yourself, you notice something out of the window.

>x window
Through the window, you can see the pole where the scarecrow once stood. In his place, you can see a strange silhouette-like figure propped against the post. It is difficult to tell from this distance, but you think that the figure is staring at you.

>n
You can't go that way.

>s
The Upstairs Hallway
You are standing in the upstairs hallway of the cottage. The only exits are back downstairs and north towards a room at the front of the cottage.As you stumble into the hallway, you feel an itch at the back of your soft sack-like head. Before you can react, a small door-mouse drops past your eyes and makes a small thud on the floor, before scurrying off downstairs.

>d
The Lobby
You are in the lobby. The room is large and mostly empty, save for a few shelves. A kitchen is to the north, while to the west is a large living room.

On one of the shelves you see an old clock.Through the door to the north you can see the barley fields, and the distant outline of the strange figure against the post.

You can see George here.

George heads west to the living room.

>n
Front Of The Cottage
You stand in front of a large two storey cottage . A field of barley lies to the North. A path leads around the side of the cottage to the southwest. The cottage itself is directly south, the entrance blocked by a heavy oak door. 

You can make out a wiry black figure resting against the post to the north. 

You see a strange figure at one of the cottage's upper windows.   

The sound of the crows is much louder now.

You can make out the figure to the north in more detail now. It is clearly humanoid in appearance, wiry and gaunt. You can't quite tell yet, but there is something not quite right about the figure's bulbous head.

You feel a cool breeze.

>n
Your'e done

    *** The End ***

In that game you scored 0 out of a possible 0, in 37 turns.

Would you like to RESTART, RESTORE a saved game, QUIT or UNDO the last command?

* * *

>get key
You can't see any such thing.

>x plough
In addition to the rust and general disrepair of the plough, it also appears to have been damaged - the blades and handles are bent at awkward angles rendering the plough useless. It is as though somebody has purposefully impaired the plough from usage.

Hanging from the plough, you see a rusty key.

The cat arrives from the northwest.

>get key
As you pick up the key, your heart jolts - you hear four loud bangs coming from the front of the cottage, like metal knocking on wood. The sound echoes around the hills and then all is silent again.

The cat heads northwest to front of the cottage.

>ne
You follow the garden path around to the front of the cottage.

As you make your way around the front of the cottage, you survey the area to see if you can identify the cause of the banging. Just as you are about to resign to having imagined the sound, you observe to your horror that the field to the north is now empty. 

The scarecrow has left his post!

You can vaguely make out that something has been nailed to the post in place of the scarecrow, flapping gently in the breeze.

Please press SPACE to continue.

Front Of The Cottage
You stand in front of a large two storey cottage . A field of barley lies to the North. A path leads around the side of the cottage to the southwest. The cottage itself is directly south, the entrance blocked by a heavy oak door. 

In the field to the north you can see something nailed to a post.  

You can see the cat here.

The cat heads north to the barley field.

>ne
The fields of corn seem to go on forever and there would be little point in entering them. The Barley Field is north. The Lobby is south. Back of the Cottage is southeast.

>unlock door with key
You unlock the Front Door.

The cat arrives from the north.

>s
(first opening the Front Door)

The Lobby
As you enter the cottage through the heavy oak door, you disturb a number of crows who were sheltering inside. A violent fury of black feathers whip past your face as the crows exit the cottage to join their brothers in the fields. 

The lobby itself is bare and largely unfurnished, with wooden floorboards that continue south into a food preparation area, and west into a large living room. A few shelves adorn the wall and a table sits against the western wall. You feel nauseous and short of breath. Surfaces feel cold and damp to the touch.

On one of the shelves you see an old clock.

the cat arrives from the north.

>stroke cat
The cat purrs loudly.

The cat appears to be carrying a black feather in his mouth. He deposits the feather on the ground in front of you and stares up at you, seeking some kind of praise.

>get feather
Taken.

The cat begins purring loudly.

>x feather
Upon closer inspection you realise that the shaft is hollow and the end is sharpened to a point. The feather is in fact a quill pen.

>w
The Living room
The living room, as with the rest of the cottage, is very sparsely furnished and ridden with dust and cobwebs. As you enter, your eye is caught by a crow at the window. The crow lets out a blood curdling screech and flies out of view.

You can see an old desk (on which is a piece of paper) here.

The cat arrives from the east.

>write george on paper
As you finish writing, you hear a "click" from upstairs.

>e
The Lobby
You are in the lobby. The room is large and mostly empty, save for a few shelves. A kitchen is to the north, while to the west is a large living room.

On one of the shelves you see an old clock.

>u
The Upstairs Hallway
You climb the creaky staircase and emerge in a small hallway. There are no windows up here, but the dim light from downstairs reveals an ominous looking door to the north. Light also emanates from the edges of the door, as if the door leads directly out into the open air.

As the creaking of the floorboards subsides, you realise that you can hear a slow, deep breathing. It appears to be coming from the other side of the door to the south.

* * *

>s
You can't go that way.

>n
(first opening the Ominous Door)

The Bedroom
You hold your breath as you enter the room, and quickly infer that this once served as the cottage's bed chamber. The room is as sparse and dusty as the rest of the cottage, the only furniture here is a ramshackle bed frame and a dressing table, on which is a dusty mirror. Light pours through a window on the far wall.Whoever had occupied this room has clearly vacated, but dusty footprints indicate that someone was definitely here.

>x mirror
You can not see clearly as the mirror is too dusty.

* * *

>x fields
Acres of barley, wheat and oat stretch over the horizon. Your eyes hurt as you stare into the horizon, and the landscape seems to throb giving you a sudden headache. The fields are wild and unkempt. Many of the crops have been ravaged by disease.

In amongst the crop here you see a folded piece of paper. It appears to be a letter.

* * *

>x cat
A small black domestic shorthair with wide yellow eyes which convey both curiosity and caution in equal measures.

The cat tilts his head to one side.

>x collar
The cat edges away warily before you can get close enough. Evidently he is still a little wary of you.

You hear the harsh "caw" of a crow.

* * *

>x cat
A small black domestic shorthair with wide yellow eyes which convey both curiosity and caution in equal measures.

The cat tilts his head to one side.

>meow at cat
You meow at the cat.

The cat tilts his head to one side.

* * *

>s
Front Of The Cottage
You approach the front of a large two storey cottage that is very familiar to you. A field of barley lies to the North. A path leads around the side of the cottage to the southwest. The cottage itself is directly south, the entrance blocked by a heavy oak door.  

The small black cat from the farm path is here, washing himself among the barley.

The cat wags his tail violently from side to side.

>scratch cat
That's not a verb I recognise.

>look south
You see nothing in that direction. Nearby: The Barley Field and Back of the Cottage and the Front Door

* * *

>x cat
A small black domestic shorthair with wide yellow eyes which convey both curiosity and caution in equal measures.

The cat tilts his head to one side.

>stroke cat
As you approach the cat, it flees into the undergrowth.

You hear the harsh "caw" of a crow.

>x fields
Acres of barley, wheat and oat stretch over the horizon. The fields are wild and unkempt. Many of the crops have been ravaged by disease.

In amongst the crop here you see a folded piece of paper. It appears to be a letter.

You feel a cool breeze.

* * *

>look up
Dull, grey clouds hang overhead.

You hear the harsh "caw" of a crow.

>help
Commands in interactive fiction are issued at the command prompt. You can go in any direction (e.g. "go north") and you issue commands in natural English (e.g. "take key" or "examine the tree"). You can re-print a room description by typing "look". Most common commands also have shortcuts, e.g. "n" will take you north, "x" will examine and "l" will look around. 

 The intention with the scarecrow is not to trick you - just try exploring and take in the world. Have fun!

>s
(first opening the wooden gate)

The Barley Field
As you enter the barley field, your mind drifts to the fields of battle in the aftermath of Waterloo. The casualties were horrendous, the victory far from glorious. Many of the soldiers who died that day, the "scum of the earth" as Wellington had described them, had been recruited from villages and hamlets nearby. Wellington had later claimed  that it was "really wonderful that we should have made these men into the fine fellows they are." You consider the barrenness of that statement  now that tens of thousands of those fine fellows are dead. Many of those who survived were not the same as they were before the war, having succumbed to war exhaustion or madness, or worse.

The chill wind is making it hard to breathe, and you begin to feel light headed. Further south through the fields you can see the old farm cottage. 

An old rotting wooden post is here. Propped up against the post, standing to attention, is a lone scarecrow.

* * *

I beg your pardon?

I beg your pardon?

>s
(first opening the wooden gate)

The Barley Field
As you survey this rural wasteland, your mind drifts to the fields of battle in the aftermath of Waterloo. The casualties were horrendous, the victory far from glorious. Many of the soldiers who died that day, the "scum of the earth" as Wellington had described them, had been recruited from villages and hamlets nearby. Wellington had later reflected that it was "really wonderful that we should have made these men into the fine fellows they are." You consider the barrenness of that statement now that tens of thousands of those fine fellows are dead. Many of those who survived were not the same as they were before the war, having succumbed to war exhaustion, madness, or worse.

The stench of death is here, exemplified by the disease-ravaged crops left to abandonment in the surrounding fields. The chill wind makes it hard to breathe, and you begin to feel light headed. Further south through the fields you can see the old farm cottage. 

An old rotting wooden post is here. Propped up against the post, standing to attention, is a lone scarecrow.

* * *

Front Of The Cottage
You stand in front of a large two storey cottage . A field of barley lies to the North. A path leads around the side of the cottage to the southwest. The cottage itself is directly south, the entrance blocked by a heavy oak door. 

In the field to the north you can see something nailed to a post.

I beg your pardon?

>unlock door
(with the rusty key)
You unlock the Front Door.

You hear the harsh "caw" of a crow.

>s
(first opening the Front Door)

The Lobby
As you enter the cottage through the heavy oak door, you disturb a number of crows who were sheltering inside. A violent fury of black feathers whip past your face as the crows exit the cottage to join their brothers in the fields. 

The lobby itself is bare and largely unfurnished, with wooden floorboards that continue south into a food preparation area, and west into a large living room. A few shelves adorn the wall and a table sits against the western wall. You feel nauseous and short of breath. Surfaces feel cold and damp to the touch.

On one of the shelves you see an old clock.

>look
The Lobby
 You are in the lobby. The room is large and mostly empty, save for a few shelves. The kitchen is to the north, while to the west is the living room.

On one of the shelves you see an old clock.

>x clock
The time reads nine minutes past three.

* * *

>x clock
The time reads eight minutes past three.

>n
Front Of The Cottage
You stand in front of a large two storey cottage . A field of barley lies to the North. A path leads around the side of the cottage to the southwest. The cottage itself is directly south, the entrance blocked by a heavy oak door. 

In the field to the north you can see something nailed to a post.

>n
The Barley Field
You are standing in a field of barley. To the north is a wooden gate leading to a farm path. A cottage lies to the south.

An old rotting wooden post is here. 

On the post is a note.

* * *

>s
Front Of The Cottage
You stand in front of a large two storey cottage . A field of barley lies to the North. A path leads around the side of the cottage to the southwest. The cottage itself is directly south, the entrance blocked by a heavy oak door. 

In the field to the north you can see something nailed to a post.  

The small black cat from the farm path is here, washing himself among the barley.

>stroke cat
You kneel down and hold your arm out towards the cat, who responds by rubbing his face against your hand and purring loudly. He seems more comfortable around you now.

The cat arches his shoulders and attempts to sneak up on a nearby crow, but it flies away moments before he pounces.

The cat appears to be carrying a black feather in his mouth. He deposits the feather on the ground in front of you and stares up at you, seeking some kind of praise.

>z
Time passes.

>l
Front Of The Cottage
You stand in front of a large two storey cottage . A field of barley lies to the North. A path leads around the side of the cottage to the southwest. The cottage itself is directly south, the entrance blocked by a heavy oak door. 

In the field to the north you can see something nailed to a post.  

You can see a black feather and the cat here.

The cat begins scratching in the undergrowth.

>get cat
I don't suppose the cat would care for that.

The cat meows.

>get feather
Taken.

The cat heads north to the barley field.

>l
Front Of The Cottage
You stand in front of a large two storey cottage . A field of barley lies to the North. A path leads around the side of the cottage to the southwest. The cottage itself is directly south, the entrance blocked by a heavy oak door. 

In the field to the north you can see something nailed to a post.  

You feel a cool breeze.

>i
You are carrying:
  a black feather
  a rusty key

The cat arrives from the north.

>x feather
You see nothing special about a black feather.

Upon closer inspection you realise that the shaft is hollow and the end is sharpened to a point. The feather is in fact a quill pen.

The cat heads southeast to back of the cottage.

>i
You are carrying:
  a black quill
  a rusty key

The cat arrives from the southeast.

* * *

>s
The kitchen
You enter a food preparation area towards the rear of the cottage. An iron-bake oven is here hung on a trammel over a fire pit. There is an old oak table in the centre of the room, and a cupboard against the far wall.

To the north is the lobby.

>x cupboard
It's closed.

>open cupboard
You open the cupboard.

>close cupboard
You close the cupboard.

* * *

I beg your pardon?

>unlock door with key
You unlock the Front Door.

You hear the harsh "caw" of a crow.

* * *

>w
The Living room
The living room, as with the rest of the cottage, is very sparsely furnished and ridden with dust and cobwebs. As you enter, your eye is caught by a crow at the window. The crow lets out a blood curdling screech and flies out of view.

You can see a desk here.

>x desk
The desk is long and coated in dust. Set into the rear of the desk is an inkwell.

* * *

>n
(first opening the Bedroom Door)
It seems to be locked.

>d
The Lobby
You are in the lobby. The room is large and mostly empty, save for a few shelves. A kitchen is to the north, while to the west is a large living room.

On one of the shelves you see an old clock.

>x clock
The time reads eleven minutes past three.

>s
The kitchen
You enter a food preparation area towards the rear of the cottage. An iron-bake oven is here hung on a trammel over a fire pit. There is an old oak table in the centre of the room, and a cupboard against the far wall.

To the north is the lobby.

* * *

>s
The Barley Field
You are standing in a field of barley. To the north is a wooden gate leading to a farm path. A cottage lies to the south.

An old rotting wooden post is here. 

On the post is a note.

>s
Front Of The Cottage
You stand in front of a large two storey cottage . A field of barley lies to the North. A path leads around the side of the cottage to the southwest. The cottage itself is directly south, the entrance blocked by a heavy oak door. 

In the field to the north you can see something nailed to a post. 

You see a strange figure at one of the cottage's upper windows. 

The small black cat from the farm path is here, washing himself among the barley.

>stroke cat
You kneel down and hold your arm out towards the cat, who responds by rubbing his face against your hand and purring loudly. He seems more comfortable around you now.

You feel a cool breeze.

The cat yawns.

The cat appears to be carrying a black feather in his mouth. He deposits the feather on the ground in front of you and stares up at you, seeking some kind of praise.

>get feather
Taken.

The cat heads southeast to back of the cottage.

>s
The Lobby
You are in the lobby. The room is large and mostly empty, save for a few shelves. A kitchen is to the north, while to the west is a large living room.

On one of the shelves you see an old clock.

>w
The Living room
The living room, as with the rest of the cottage, is very sparsely furnished and ridden with dust and cobwebs. As you enter, your eye is caught by a crow at the window. The crow lets out a blood curdling screech and flies out of view.

You can see an old desk (on which is a piece of paper) here.

>write hello
You should try writing something ON something...

>write hello on paper
You do not have anything to write with.

>x feather
Upon closer inspection you realise that the shaft is hollow and the end is sharpened to a point. The feather is in fact a quill pen.

>write hello on paper
You dip your quill into the inkwell and write "hello" onto the piece of paper, but after a few seconds the lettering slowly fades away.

>write george on paper
As you finish writing, you hear a "click" from upstairs.

* * *

>ne
You follow the garden path around to the front of the cottage.

As you make your way around the front of the cottage, you survey the area to see if you can identify the cause of the banging. Just as you are about to resign to having imagined the sound, you observe to your horror that the field to the north is now empty. 

The scarecrow has left his post!

You can vaguely make out that something has been nailed to the post in place of the scarecrow, flapping gently in the breeze.

Please press SPACE to continue.

Front Of The Cottage
You stand in front of a large two storey cottage . A field of barley lies to the north. A path leads around the side of the cottage to the southwest. The cottage itself is directly south, the entrance blocked by a heavy oak door.

 

In the field to the north you can see something nailed to a post. 

You hear the harsh "caw" of a crow.

I beg your pardon?

>unlock door
(with the rusty key)
You unlock the Front Door.

You feel a cool breeze.

* * *

>x cupboard
Whilst at some point the cupboard may have once been used to store various spices and root vegetables, it is presently bare save for a few cobwebs.

>x cobwebs
Light, wispy cobwebs seem to cover every surface.

* * *

I beg your pardon?

>n
The Barley Field
You are standing in a field of barley. To the north is a wooden gate leading to a farm path. A cottage lies to the south.

An old rotting wooden post is here. 

On the post is a note.

* * *

>x note
There is a message written on the note in what looks like charcoal. The author has used aggressive straight lines to etch out each letter. The message reads:

"Your place is in the fields"

>s
Front Of The Cottage
You stand in front of a large two storey cottage . A field of barley lies to the north. A path leads around the side of the cottage to the southwest. The cottage itself is directly south, the entrance blocked by a heavy oak door.

 

In the field to the north you can see something nailed to a post. 

You see a strange figure at one of the cottage's upper windows.

You feel a cool breeze.

* * *

>s
Front Of The Cottage
You approach the front of a large two storey cottage that is very familiar to you. A field of barley lies to the North. A path leads around the side of the cottage to the southwest. The cottage itself is directly south, the entrance blocked by a heavy oak door.

>se
You follow garden path to the back of the cottage.

Back of the Cottage
You arrive in an ample-sized clearing of trampled barley which serves as a yard for the cottage.

You feel a slight twinge in your knee and wince in pain as you correct yourself. In that instant your thoughts turn to musket fire and the mayhem of battle, and to the sharp and sudden trauma below your right femur. 

And to falling.

You take a moment to gather your composure. You close your eyes and begin repeating to yourself "You are home. You are alive. " Eventually you open your eyes and breathe in the cold country air.

On the perimeter of the clearing is an old, broken plough.

* * *

Front Of The Cottage
You stand in front of a large two storey cottage . A field of barley lies to the North. A path leads around the side of the cottage to the southwest. The cottage itself is directly south, the entrance blocked by a heavy oak door. 

In the field to the north you can see something nailed to a post.  

You hear the harsh "caw" of a crow.

I beg your pardon?

* * *

>unlock door
(with the rusty key)
You unlock the Front Door.

You feel a cool breeze.

>x clock
You can't see any such thing.

* * *

>x clock
The time reads nine minutes past three.

>n
Front Of The Cottage
You stand in front of a large two storey cottage . A field of barley lies to the North. A path leads around the side of the cottage to the southwest. The cottage itself is directly south, the entrance blocked by a heavy oak door. 

In the field to the north you can see something nailed to a post.  

the cat arrives from the north.

* * *

>s
Front Of The Cottage
You approach the front of a large two storey cottage that is very familiar to you. A field of barley lies to the north. A path leads around the side of the cottage to the southwest. The cottage itself is directly south, the entrance blocked by a heavy oak door.The crows continue to circle and caw all around, landing on the various protrusions around the cottage. 

You feel suddenly very sad, as if there is something at work in your soul which you do not understand.

>se
You follow garden path to the back of the cottage.

Back of the Cottage
You arrive in an ample-sized clearing of trampled barley which serves as a yard for the cottage.

You feel a slight twinge in your knee and wince in pain as you correct yourself. In that instant your thoughts turn to musket fire and the mayhem of battle, and to the sharp and sudden trauma below your right femur. 

And to falling.

You take a moment to gather your composure. You close your eyes and begin repeating to yourself "You are home. You are alive. " Eventually you open your eyes and breathe in the cold country air.

On the perimeter of the clearing is an old, broken plough. You can also see an ancient gnarled tree here.

* * *

I beg your pardon?

>unlock door with key
You unlock the Front Door.

* * *

>s
Front Of The Cottage
You approach the front of a large two storey cottage that is very familiar to you. A field of barley lies to the north. A path leads around the side of the cottage to the southwest. The cottage itself is directly south, the entrance blocked by a heavy oak door.The crows continue to circle and caw all around, landing on the various protrusions around the cottage. 

You feel suddenly very sad, as if there is something at work in your soul which you do not understand.

>s
(first opening the Front Door)
You heave with all of your might but the heavy oak door will not budge. It appears to be locked.

* * *

>ne
You follow the garden path around to the front of the cottage.

As you make your way around the front of the cottage, you survey the area to see if you can identify the cause of the banging. Just as you are about to resign to having imagined the sound, you observe to your horror that the field to the north is now empty. 

The scarecrow has left his post!

You can vaguely make out that something has been nailed to the post in place of the scarecrow, flapping gently in the breeze.

Please press SPACE to continue.

Front Of The Cottage
You stand in front of a large two storey cottage . A field of barley lies to the north. A path leads around the side of the cottage to the southwest. The cottage itself is directly south, the entrance blocked by a heavy oak door. 

In the field to the north you can see something nailed to a post. 

You hear the harsh "caw" of a crow.

I beg your pardon?

* * *

>x note
There is a message written on the note in what looks like charcoal. The author has used aggressive straight lines to etch out each letter. The message reads:

"Your place is in the fields"

>s
Front Of The Cottage
You stand in front of a large two storey cottage . A field of barley lies to the north. A path leads around the side of the cottage to the southwest. The cottage itself is directly south, the entrance blocked by a heavy oak door. 

In the field to the north you can see something nailed to a post. 

You see a strange figure at one of the cottage's upper windows.
You feel a cool breeze.

>x figure
You see a strange figure at the window.

As your eyes begin to focus more clearly, the figure fades from view. Was it even there in the first place?

>l
Front Of The Cottage
You stand in front of a large two storey cottage . A field of barley lies to the north. A path leads around the side of the cottage to the southwest. The cottage itself is directly south, the entrance blocked by a heavy oak door. 

In the field to the north you can see something nailed to a post.

* * *

I beg your pardon?

>s
(first opening the wooden gate)

The Barley Field
As you enter the barley field, your mind drifts to the fields of battle in the aftermath of Waterloo. The casualties were horrendous, the victory far from glorious. Many of the soldiers who died that day, the "scum of the earth" as Wellington had described them, had been recruited from villages and hamlets nearby. Wellington had later reflected that it was "really wonderful that we should have made these men into the fine fellows they are." You consider the barrenness of that statement  now that tens of thousands of those fine fellows are dead. Many of those who survived were not the same as they were before the war, having succumbed to war exhaustion or madness, or worse.

The chill wind is making it hard to breathe, and you begin to feel light headed. Further south through the fields you can see the old farm cottage. 

An old rotting wooden post is here. Propped up against the post, standing to attention, is a lone scarecrow.

You hear the harsh "caw" of a crow.

>s
Front Of The Cottage
You approach the front of a large two storey cottage that is very familiar to you. A field of barley lies to the North. A path leads around the side of the cottage to the southwest. The cottage itself is directly south, the entrance blocked by a heavy oak door.

* * *

I beg your pardon?

>unlock door with key
You unlock the Front Door.

You feel a cool breeze.

>s
(first opening the Front Door)

The Lobby
As you enter the cottage through the heavy oak door, you disturb a number of crows who were sheltering inside. A violent fury of black feathers whip past your face as the crows exit the cottage to join their brothers in the fields. 

The lobby itself is bare and largely unfurnished, with wooden floorboards that continue south into a food preparation area, and west into a large living room. A few shelves adorn the wall and a table sits against the western wall. You feel nauseous and short of breath. Surfaces feel cold and damp to the touch.

On one of the shelves you see an old clock.

* * *

>w
The Living room
The living room, as with the rest of the cottage, is very sparsely furnished and ridden with dust and cobwebs. As you enter, your eye is caught by a crow at the window. The crow lets out a blood curdling screech and flies out of view.

You can see a desk here.

>x desk
The desk is long and coated in dust. Set into the rear of the desk is an inkwell. Stuck to the desk is a note.

* * *

I beg your pardon?

>write gay on gate
You do not have anything to write with.

The cat tilts his head to one side.

>s
(first opening the wooden gate)

The Barley Field
As you enter the barley field, your mind drifts to the fields of battle in the aftermath of Waterloo. The casualties were horrendous, the victory far from glorious. Many of the soldiers who died that day, the "scum of the earth" as Wellington had described them, had been recruited from villages and hamlets nearby. Wellington had later reflected that it was "really wonderful that we should have made these men into the fine fellows they are." You consider the barrenness of that statement  now that tens of thousands of those fine fellows are dead. Many of those who survived were not the same as they were before the war, having succumbed to war exhaustion or madness, or worse.

The chill wind is making it hard to breathe, and you begin to feel light headed. Further south through the fields you can see the old farm cottage. 

An old rotting wooden post is here. Propped up against the post, standing to attention, is a lone scarecrow.

* * *

>s
Front Of The Cottage
You approach the front of a large two storey cottage that is very familiar to you. A field of barley lies to the North. A path leads around the side of the cottage to the southwest. The cottage itself is directly south, the entrance blocked by a heavy oak door.

>sw
You follow garden path to the back of the cottage.

Back of the Cottage
You arrive in an ample-sized clearing of trampled barley which serves as a yard for the cottage.

You feel a slight twinge in your knee and wince in pain as you correct yourself. In that instant your thoughts turn to musket fire and the mayhem of battle, and to the sharp and sudden trauma below your right femur. 

And to falling.

You take a moment to gather your composure. You close your eyes and begin repeating to yourself "You are home. You are alive. " Eventually you open your eyes and breathe in the cold country air.

On the perimeter of the clearing is an old, broken plough. You can also see an ancient gnarled tree here.

* * *

>x clock
The time reads nine minutes past three.

>n
Front Of The Cottage
You stand in front of a large two storey cottage . A field of barley lies to the North. A path leads around the side of the cottage to the southwest. The cottage itself is directly south, the entrance blocked by a heavy oak door. 

In the field to the north you can see something nailed to a post.  

You hear the harsh "caw" of a crow.

* * *

>n
The Barley Field
You are standing in a field of barley. To the north is a wooden gate leading to a farm path. A cottage lies to the south.

An old rotting wooden post is here. 

On the post is a note.

>n
The Farm Path
A wooden gate to the south leads to a field of barley. 

You see a small black cat sheltering under some nearby foliage.

The cat wags his tail violently from side to side.

>stroke cat
As you approach the cat, it flees into the undergrowth.

* * *

>s
The Barley Field
You are standing in a field of barley. To the north is a wooden gate leading to a farm path. A cottage lies to the south.

An old rotting wooden post is here. 

On the post is a note.

>s
Front Of The Cottage
You stand in front of a large two storey cottage . A field of barley lies to the North. A path leads around the side of the cottage to the southwest. The cottage itself is directly south, the entrance blocked by a heavy oak door. 

In the field to the north you can see something nailed to a post.  

The small black cat from the farm path is here, washing himself among the barley.

The cat blinks slowly with one eye  and stares at you.

>stroke cat
You kneel down and hold your arm out towards the cat, who responds by rubbing his face against your hand and purring loudly. He seems more comfortable around you now.

The cat arches his shoulders and attempts to sneak up on a nearby crow, but it flies away moments before he pounces.

The cat appears to be carrying a black feather in his mouth. He deposits the feather on the ground in front of you and stares up at you, seeking some kind of praise.

>get feather
Taken.

>s
The Lobby
You are in the lobby. The room is large and mostly empty, save for a few shelves. A kitchen is to the north, while to the west is a large living room.

On one of the shelves you see an old clock.

* * *

>w
The Living room
The living room, as with the rest of the cottage, is very sparsely furnished and ridden with dust and cobwebs. As you enter, your eye is caught by a crow at the window. The crow lets out a blood curdling screech and flies out of view.

You can see an old desk (on which is a piece of paper) here.

>write Wellington on paper
You write shit down.

>drop feather
Dropped.

>write Wellington on paper
You do not have anything to write with.

>write fuck off on paper
You do not have anything to write with.

>get feather
Taken.

>write fuck off on paper
You write "fuck off" onto the piece of paper. After a few seconds, your scrawl slowly fades away.

* * *

>write hello on sky
You can't see any such thing.

* * *

>write hello
You can't see any such thing.

* * *

>write foo
You must supply a second noun.

>write foo on gate
Bar.

You hear the harsh "caw" of a crow.

The cat tilts his head to one side.

* * *

>write foo on gate
You write other shit down but it dissapears.

The cat tilts his head to one side.

>write bar on gate
bar.

* * *

>write foo on gate
You write other shit down but it dissapears.

The cat tilts his head to one side.

>write wellington on gate
You write shit down.

* * *

>write foo on gate
You write other shit down but it dissapears.

The cat tilts his head to one side.

>s
(first opening the wooden gate)

The Barley Field
As you enter the barley field, your mind drifts to the fields of battle in the aftermath of Waterloo. The casualties were horrendous, the victory far from glorious. Many of the soldiers who died that day, the "scum of the earth" as Wellington had described them, had been recruited from villages and hamlets nearby. Wellington had later reflected that it was "really wonderful that we should have made these men into the fine fellows they are." You consider the barrenness of that statement  now that tens of thousands of those fine fellows are dead. Many of those who survived were not the same as they were before the war, having succumbed to war exhaustion or madness, or worse.

The chill wind is making it hard to breathe, and you begin to feel light headed. Further south through the fields you can see the old farm cottage. 

An old rotting wooden post is here. Propped up against the post, standing to attention, is a lone scarecrow.

>write fuck off on scarecrow
No point.

>write foo
I didn't understand that sentence.

* * *

>write goo on gate
You write other shit down.

>write wellington on gate
You write shit down.

* * *

>write gay
You should try writing something ON something...

>write gay on gate
You do not have anything to write with.

The cat tilts his head to one side.

* * *

>write gay on gate
You do not have anything to write with.

>s
(first opening the wooden gate)

The Barley Field
As you enter the barley field, your mind drifts to the fields of battle in the aftermath of Waterloo. The casualties were horrendous, the victory far from glorious. Many of the soldiers who died that day, the "scum of the earth" as Wellington had described them, had been recruited from villages and hamlets nearby. Wellington had later reflected that it was "really wonderful that we should have made these men into the fine fellows they are." You consider the barrenness of that statement  now that tens of thousands of those fine fellows are dead. Many of those who survived were not the same as they were before the war, having succumbed to war exhaustion or madness, or worse.

The chill wind is making it hard to breathe, and you begin to feel light headed. Further south through the fields you can see the old farm cottage. 

An old rotting wooden post is here. Propped up against the post, standing to attention, is a lone scarecrow.

You hear the harsh "caw" of a crow.

* * *

Front Of The Cottage
You stand in front of a large two storey cottage . A field of barley lies to the North. A path leads around the side of the cottage to the southwest. The cottage itself is directly south, the entrance blocked by a heavy oak door. 

In the field to the north you can see something nailed to a post.  

You feel a cool breeze.

>unlock door with key
You unlock the Front Door.

* * *

>x clock
The time reads nine minutes past three.

>n
Front Of The Cottage
You stand in front of a large two storey cottage . A field of barley lies to the North. A path leads around the side of the cottage to the southwest. The cottage itself is directly south, the entrance blocked by a heavy oak door. 

In the field to the north you can see something nailed to a post.

* * *

>n
The Barley Field
You are standing in a field of barley. To the north is a wooden gate leading to a farm path. A cottage lies to the south.

An old rotting wooden post is here. 

On the post is a note.

>n
The Farm Path
A wooden gate to the south leads to a field of barley. 

You see a small black cat sheltering under some nearby foliage.

You hear the harsh "caw" of a crow.

The cat tilts his head to one side.

* * *

>s
The Barley Field
You are standing in a field of barley. To the north is a wooden gate leading to a farm path. A cottage lies to the south.

An old rotting wooden post is here. 

On the post is a note.

>s
Front Of The Cottage
You stand in front of a large two storey cottage . A field of barley lies to the North. A path leads around the side of the cottage to the southwest. The cottage itself is directly south, the entrance blocked by a heavy oak door. 

In the field to the north you can see something nailed to a post.  

The small black cat from the farm path is here, washing himself among the barley.

The cat wags his tail violently from side to side.

>stroke cat
You kneel down and hold your arm out towards the cat, who responds by rubbing his face against your hand and purring loudly. He seems more comfortable around you now.

The cat appears to be carrying a black feather in his mouth. He deposits the feather on the ground in front of you and stares up at you, seeking some kind of praise.

>get feather
Taken.

The cat heads north to the barley field.

>s
The Lobby
You are in the lobby. The room is large and mostly empty, save for a few shelves. A kitchen is to the north, while to the west is a large living room.

On one of the shelves you see an old clock.

* * *

>talk to cat
The cat tilts his head to one side.

>say hello to cat
There is no reply.

>say hello to cat
There is no reply.

>say hello to cat
There is no reply.

The cat wags his tail violently from side to side.

* * *

>talk to ca
You can't see any such thing.

>talk to cat
What do you want to say?

>say hello to cat
There is no reply.

You hear the harsh "caw" of a crow.

The cat tilts his head to one side.

>ask cat about ha
There is no reply.

* * *

>say hello to cat
The cat looks confused.

The cat tilts his head to one side.

>ask cat about himself
The cat looks confused.

* * *

>say hello to cat
The cat looks confused.

The cat tilts his head to one side.

>ask cat about himeslf
The cat looks confused.

* * *

>say hello to cat
The cat looks confused.

The cat tilts his head to one side.

>say no to cat
That was a rhetorical question.

>say no
(to the cat)
That was a rhetorical question.

You feel a cool breeze.

* * *

>say hello to ca
You can't see any such thing.

>say hello to cat
There is no reply.

* * *

>look under cat
You find nothing of interest.

You hear the harsh "caw" of a crow.

* * *

>stroke cat
As you approach the cat, it flees into the undergrowth.

>s
(first opening the wooden gate)

The Barley Field
As you survey this rural wasteland, your mind drifts to the fields of battle in the aftermath of Waterloo. The casualties were horrendous, the victory far from glorious. Many of the soldiers who died that day, the "scum of the earth" as Wellington had described them, had been recruited from villages and hamlets nearby. Wellington had later reflected that it was "really wonderful that we should have made these men into the fine fellows they are." You consider the barrenness of that statement now that tens of thousands of those fine fellows are dead. Many of those who survived were not the same as they were before the war, having succumbed to war exhaustion, madness, or worse.

The stench of death is here, exemplified by the disease-ravaged crops left to abandonment in the surrounding fields. The chill wind makes it hard to breathe, and you begin to feel light headed. Further south through the fields you can see the old farm cottage. 

An old rotting wooden post is here. Propped up against the post, standing to attention, is a lone scarecrow.

You hear the harsh "caw" of a crow.

>s
Front Of The Cottage
You approach the front of a large two storey cottage that is very familiar to you. A field of barley lies to the north. A path leads around the side of the cottage to the southwest. The cottage itself is directly south, the entrance blocked by a heavy oak door.

The crows continue to circle and caw all around, landing on the various protrusions around the cottage. 

You feel suddenly very sad, as if there is something at work in your soul which you do not understand.   

The small black cat from the farm path is here, washing himself among the barley. 

You feel a cool breeze.

The cat tilts his head to one side.

>se
You follow garden path to the back of the cottage.

Back of the Cottage
You arrive in an ample-sized clearing of trampled barley which serves as a yard for the cottage.

You feel a slight twinge in your knee and wince in pain as you correct yourself. In that instant your thoughts turn to musket fire and the mayhem of battle, and to the sharp and sudden trauma below your right femur. 

And to falling.

You take a moment to gather your composure. You close your eyes and begin repeating to yourself "You are home. You are alive. " Eventually you open your eyes and breathe in the cold country air.

On the perimeter of the clearing is an old, broken plough. You can also see an ancient gnarled tree here.

>x tree
An old, gnarled tree. The tree is bereft of leaves and extends around twenty feet into the air with menacing, claw-like branches. The tree appears to have lost several branches, and is scarred with what you presume to be lightning damage.

Tucked into a large knot in the bark of the tree you see a folded piece of paper - it appears to be a letter.

>x plough
In addition to the rust and general disrepair of the plough, it also appears to have been damaged - the blades and handles are bent at awkward angles rendering the plough useless. It is as though somebody has purposefully impaired the plough from usage.

Hanging from the plough, you see a rusty key.

* * *

Front Of The Cottage
You stand in front of a large two storey cottage . A field of barley lies to the North. A path leads around the side of the cottage to the southwest. The cottage itself is directly south, the entrance blocked by a heavy oak door. 

In the field to the north you can see something nailed to a post.  

The small black cat from the farm path is here, washing himself among the barley.

>stroke cat
You kneel down and hold your arm out towards the cat, who responds by rubbing his face against your hand and purring loudly. He seems more comfortable around you now.

The cat heads southeast to back of the cottage.

>unlock door with key
You unlock the Front Door.

* * *

>u
The Upstairs Hallway
You climb the creaky staircase and emerge in a small hallway. There are no windows up here, but the dim light from downstairs reveals an ominous looking door to the north. Light also emanates from the edges of the door, as if the door leads directly out into the open air.

As the creaking of the floorboards subsides, you realise that you can hear a slow, deep breathing. It appears to be coming from the other side of the door to the south.

>d
The Lobby
You are in the lobby. The room is large and mostly empty, save for a few shelves. A kitchen is to the north, while to the west is a large living room.

On one of the shelves you see an old clock.

the cat arrives from the north.

>w
The Living room
The living room, as with the rest of the cottage, is very sparsely furnished and ridden with dust and cobwebs. As you enter, your eye is caught by a crow at the window. The crow lets out a blood curdling screech and flies out of view.

You can see an old desk (on which is a piece of paper) here.

the cat arrives from the east.

* * *

>x desk
The desk is long and coated in dust. Set into the rear of the desk is an inkwell. On to the desk is a note. The not appears to be stuck to the desk with some kind of adhesive.

On the old desk is a piece of paper.

The cat appears to be carrying a black feather in his mouth. He deposits the feather on the ground in front of you and stares up at you, seeking some kind of praise.

>praise cat
The cat purrs loudly.

The cat meows.

>get feather
Taken.

The cat heads east to the lobby.

>x feather
Upon closer inspection you realise that the shaft is hollow and the end is sharpened to a point. The feather is in fact a quill pen.

>write george on paper
As you finish writing, you hear a "click" from upstairs.

>u
You can't go that way.

>e
The Lobby
You are in the lobby. The room is large and mostly empty, save for a few shelves. A kitchen is to the north, while to the west is a large living room.

On one of the shelves you see an old clock.

You can see the cat here.

>u
The Upstairs Hallway
You are standing in the upstairs hallway of the cottage.

* * *

>stroke cat
You kneel down and hold your arm out towards the cat, who responds by rubbing his face against your hand and purring loudly. He seems more comfortable around you now.

The cat yawns.

>se
You follow garden path to the back of the cottage.

Back of the Cottage
You arrive in an ample-sized clearing of trampled barley which serves as a yard for the cottage.

You feel a slight twinge in your knee and wince in pain as you correct yourself. In that instant your thoughts turn to musket fire and the mayhem of battle, and to the sharp and sudden trauma below your right femur. 

And to falling. And to the wet earth.

You take a moment to gather your composure. You close your eyes and begin repeating to yourself "You are home. You are alive. " Eventually you open your eyes and breathe in the cold country air.

On the perimeter of the clearing is an old, broken plough. You can also see an ancient gnarled tree here.

* * *

>ne
You follow the garden path around to the front of the cottage.

As you make your way around the front of the cottage, you survey the area to see if you can identify the cause of the banging. Just as you are about to resign to having imagined the sound, you observe to your horror that the field to the north is now empty. 

The scarecrow has left his post!

You can vaguely make out that something has been nailed to the post in place of the scarecrow, flapping gently in the breeze.

Please press SPACE to continue.

Front Of The Cottage
You stand in front of a large two storey cottage . A field of barley lies to the north. A path leads around the side of the cottage to the southwest. The cottage itself is directly south, the entrance blocked by a heavy oak door.

 

In the field to the north you can see something nailed to a post.

>unlock door with key
You unlock the Front Door.

>s
(first opening the Front Door)

The Lobby
As you enter the cottage through the heavy oak door, you disturb a number of crows who were sheltering inside. A violent fury of black feathers whip past your face as the crows exit the cottage to join their brothers in the fields. 

The lobby itself is bare and largely unfurnished, straw is scattered liberally across the floorboards, which continue south into a food preparation area, and west into a large living room. The room is empty save for a few shelves. 

 You feel nauseous and short of breath. Surfaces feel cold and damp to the touch.

On one of the shelves you see an old clock.

An old rickety staircase leads upstairs.

>w
The Living room
The living room, as with the rest of the cottage, is very sparsely furnished and ridden with dust and cobwebs. As you enter, your eye is caught by a crow at the window. The crow lets out a blood curdling screech and flies out of view.

You can see an old desk (on which is a piece of paper) here.

>z
Time passes.

the cat arrives from the east.

>z
Time passes.

The cat heads east to the lobby.

the cat arrives from the east.

>z
Time passes.

The cat sits in silence, staring at you.

The cat appears to be carrying a black feather in his mouth. He deposits the feather on the ground in front of you and stares up at you, seeking some kind of praise.

>get feather
Taken.

* * *

>e
You can't go that way.

* * *

>u
The Upstairs Hallway
You climb the creaky staircase and emerge in a small hallway. There are no windows up here, but the dim light from downstairs reveals an ominous looking door to the north. Light also emanates from the edges of the door, as if the door leads directly out into the open air. You can just about see that something is etched onto the door.

As the creaking of the floorboards subsides, you realise that you can hear a slow, deep breathing. It appears to be coming from the other side of the door to the north.

>x door
A dusty timber door. Someone has etched the outline of a cat into the centre. The gap at the bottom of the door looks wide enough to see under.

>look under door
You put your head against the floor and peer under the crack at the base of the door. It is bright but you can make out two large shadows very close to the door. Are those feet? You can still hear the breathing, you consider whether listening to the door might help you identify the sound more clearly.

the cat arrives from below.

>knock on door
You knock three times on the door, the sound echoes around the cottage and then all is quiet again. You realise that the breathing on the other side appears to have stopped. Your contemplation is suddenly interrupted by three very loud bangs, as if someone on the other side of the door was thumping against the wood with all of their might. The sound causes the whole cottage to vibrate.

After a few moments, the slow breathing resumes. You conclude that the only way you are getting through this door is to figure out how to unlock it. Perhaps you should explore the rest of the cottage for clues?

The cat heads down to the lobby.

the cat arrives from below.

>d
The Lobby
You are in the lobby. The room is large and mostly empty, save for a few shelves. A kitchen is to the south, while to the west is a large living room.

On one of the shelves you see an old clock.

An old rickety staircase leads upstairs.

The cat arrives from the up.

The cat appears to be carrying a black feather in his mouth. He deposits the feather on the ground in front of you and stares up at you, seeking some kind of praise.

>get feather
Taken.

The cat stares at the wall as if distracted by something, but there is nothing there.

>w
The Living room
The living room, as with the rest of the cottage, is very sparsely furnished and ridden with dust and cobwebs. As you enter, your eye is caught by a crow at the window. The crow lets out a blood curdling screech and flies out of view.

You can see an old desk (on which is a piece of paper) here.

The cat arrives from the east.

>write george on paper
You do not have anything to write with.

The cat meows.

>x feather
Upon closer inspection you realise that the shaft is hollow and the end is sharpened to a point. The feather is in fact a quill pen.

The cat heads east to the lobby.

>write george on paper
As you finish writing, you hear a "click" from upstairs, as if a door were being unlocked.

>e
The Lobby
You are in the lobby. The room is large and mostly empty, save for a few shelves. A kitchen is to the south, while to the west is a large living room.

On one of the shelves you see an old clock.

An old rickety staircase leads upstairs.

You can see the cat here.

>u
The Upstairs Hallway
You are standing in the upstairs hallway of the cottage. The only exits are back downstairs and north towards a room at the front of the cottage.

>n
(first opening the Ominous Door)

The Bedroom
You hold your breath as you enter the room, and you find yourself alone.  The room is as sparse and dusty as the rest of the cottage, a ramshackle bed frame is situated against the east wall next to an old dressing table, on which is a dusty mirror. Light pours through a large window on the far wall. The only exit is south to the hallway.

Whoever had occupied this room has clearly vacated - only a set of dusty footprints indicate that anyone was ever here.

>clean mirror
You wipe away the dust from the mirror.

>x mirror
*** Run-time problem P1: Tried to move the strapped figure (a backdrop) to The Bedroom, which is not a region.

As you stare into the glass of the mirror, you realise to your horror that visage staring back at you is that of a scarecrow. You jolt backwards only to see the scarecrow jolt identically. You bring your right hand up to your face, and once again your reflection reciprocates. You contemplate in disbelief that you are a mere facsimile of a man, a thing of straw and cloth. You stumble backwards and use the bed frame to support yourself.

As you correct yourself, you notice something out of the window.

>s
The Upstairs Hallway
You are standing in the upstairs hallway of the cottage. The only exits are back downstairs and north towards a room at the front of the cottage.

As you stumble into the hallway, you feel an itch at the back of your soft sack-like head. Before you can react, a small dormouse drops past your eyes and makes a small thud on the floor, before scurrying off downstairs.

>d
The Lobby
You are in the lobby. The room is large and mostly empty, save for a few shelves. A kitchen is to the south, while to the west is a large living room.

On one of the shelves you see an old clock.

An old rickety staircase leads upstairs.

Through the door to the north you can see the barley fields, and the distant outline of the strange figure against the post.

>n
Front Of The Cottage
You stand in front of a large two storey cottage . A field of barley lies to the north. A path leads around the side of the cottage to the southwest. The cottage itself is directly south, the entrance blocked by a heavy oak door.

 

You can make out a wiry black figure resting against the post to the north.    

The sound of the crows is much louder now.

You can make out the figure to the north in more detail now. It is clearly humanoid in appearance, wiry and gaunt. You can't quite tell yet, but there is something not quite right about the figure's bulbous head.

>n
As you enter the barley field, you see that a wiry figure now stands in place of the scarecrow. As you approach, you realise that the figure, with its glossy black fur and long, sharp fingernails is  neither cat nor human but some kind of monstrous chimera. The creature's emerald eyes focus on you as you move closer towards it, following you as you draw closer. Around its neck hangs a battered wooden plank, upon which is written the name "George".

The cat, as you choose to perceive it, is smiling widely, revealing two yellowing fangs beneath brownish lips. He begins to speak;

"Well done, my fine fellow, well done" he laughs, "Haha, nothing contributes so much to tranquillise the mind as a steady purpose! It wasn't easy but we bloody well did it didn't we! The enemy was nought but a pounder after all!"

The creature notices your confusion.

"I know, nothing is so painful to the human mind as a great and sudden change, but don't you see lad, it's over!" he spins his head around in almost a complete circle, gesturing to the surrounding landscape "We won! You don't need to defend this land any more, you can return to your old life! Haha!"

George furrows his brow as he notices that you still don't quite understand what he is implying.

"Look" he continues "There is little point in you resuming your station here, boy, these fields are no longer in need of defence!"

He is clearly losing his patience at your lack of response. His voice takes on a sudden stern-ness.

"I desire what is good. Therefore, everyone who does not agree with me is a traitor. It is good that you have done this service for your kingdom, but your services are no longer required and therefore it is good that you should return to your old life. Unless, that is, you disagree with me?"

Please press SPACE to continue.

In a field of barley stands a rotting wooden post. Next to the post a soggy hessian sack, a red coat, a pair of wellington boots, a hat and a pair of grey trousers lie in a crumpled heap. In a puddle, in a field, in Suffolk.

Crows circle overhead.

Please press SPACE to continue.

Thank you for playing The Scarecrow. It may be of interest to you that the letters scattered throughout the game are fragments from an actual letter from an un-named soldier to his father in the wake of Waterloo, which was published in the Caledonian Mercury on 3 July 1815.

In addition, the text is littered with quotes from Frankenstein as well as actual historical quotes (or, variations upon said quotes)

Finally, thank you to Laura, Matty P, Bennos, Holly and Gary for helping with the playtesting.

Please press SPACE to continue.

    *** The End ***

Would you like to RESTART, RESTORE a saved game, QUIT or UNDO the last command?

* * *

>unlock door with key
You unlock the Front Door.

>n
The Barley Field
You are standing in a field of barley. To the north is a wooden gate leading to a farm path. A cottage lies to the south.

An old rotting wooden post is here. 

On the post is a note.

You feel a cool breeze.

>x note
There is a message inscribed onto the note in what looks like charcoal. The author has used aggressive straight lines to etch out each letter. The message reads:

"Your place is in the fields"

>s
Front Of The Cottage
You stand in front of a large two storey cottage . A field of barley lies to the North. A path leads around the side of the cottage to the southwest. The cottage itself is directly south, the entrance blocked by a heavy oak door.

The crows continue to circle and caw all around, landing on the various protrusions on and around the cottage. 

In the field to the north you can see something nailed to a post.  

You see a strange figure at one of the cottage's upper windows.  

You can see the cat here.

>x figure
You see a strange figure at the window.

As your eyes begin to focus more clearly, the figure fades from view. Was it even there in the first place?

>n
The Barley Field
You are standing in a field of barley. To the north is a wooden gate leading to a farm path. A cottage lies to the south.

An old rotting wooden post is here. 

On the post is a note.

>s
Front Of The Cottage
You stand in front of a large two storey cottage . A field of barley lies to the North. A path leads around the side of the cottage to the southwest. The cottage itself is directly south, the entrance blocked by a heavy oak door.

The crows continue to circle and caw all around, landing on the various protrusions on and around the cottage. 

In the field to the north you can see something nailed to a post.    

You can see the cat here.

>s
(first opening the Front Door)

The Lobby
As you enter the cottage through the heavy oak door, you disturb a number of crows who were sheltering inside. A violent fury of black feathers whip past your face as the crows exit the cottage to join their brothers in the fields. 

The lobby itself is bare and largely unfurnished, with wooden floorboards that continue south into a food preparation area, and west into a large living room. A few shelves adorn the wall and a table sits against the western wall. You feel nauseous and short of breath. Surfaces feel cold and damp to the touch.

On one of the shelves you see an old clock.

the cat arrives from the north.

* * *

>w
The Living room
The living room, as with the rest of the cottage, is very sparsely furnished and ridden with dust and cobwebs. As you enter, your eye is caught by a crow at the window. The crow lets out a blood curdling screech and flies out of view.

You can see an old desk (on which is a piece of paper) here.

the cat arrives from the east.

>x desk
The desk is long and coated in dust. Set into the rear of the desk is an inkwell. On to the desk is a note. The not appears to be stuck to the desk with some kind of adhesive.

On the old desk is a piece of paper.

The cat meows.

The cat appears to be carrying a black feather in his mouth. He deposits the feather on the ground in front of you and stares up at you, seeking some kind of praise.

>get feather
Taken.

>x paper
You lean over the desk to read the message:

He hides away during the maelstrom, emerging only when he knows the landscape to be free from hazard. He wanders the fields, surveying the aftermath to amuse his curiosity. He greets the soldier as a friend, even though the two are strangers. The people still people warm to him, though he claws at their humility only to stroke his wretched ego.

He offers meagre trifles, but he is not to be trusted. Damn him, he who is named _________________________. 

At the foot of the paper is a dotted line, indicating that a word is missing.

The cat sits in silence, staring at you.

>x cat
A small black cat with wide, yellow eyes. The cat is wearing a silver collar.

>x collar
The cats name is George.

>e
The Lobby
You are in the lobby. The room is large and mostly empty, save for a few shelves. A kitchen is to the north, while to the west is a large living room.

On one of the shelves you see an old clock.

* * *

>s
The kitchen
You enter a food preparation area towards the rear of the cottage. An iron-bake oven is here hung on a trammel over a fire pit. There is an old oak table in the centre of the room, and a cupboard against the far wall.

To the north is the lobby.

>x table
An old oak table of sturdy build, the table is coated in a thin layer of dust.

>open cupboard
You open the cupboard.

* * *

>x cupboard
Whilst at some point the cupboard may have once been used to store various spices and root vegetables, it is presently bare save for a few cobwebs.

>x table
An old oak table of sturdy build, the table is coated in a thin layer of dust.

>l
The kitchen
You are in the food preparation area towards the rear of the cottage. An iron-bake oven is here hung on a trammel over a fire pit. There is an old oak table in the centre of the room, and a cupboard against the far wall.

To the north is the lobby.

>s
You can't go that way.

>n
The Lobby
You are in the lobby. The room is large and mostly empty, save for a few shelves. A kitchen is to the north, while to the west is a large living room.

On one of the shelves you see an old clock.

You can see George here.

>w
The Living room
You are standing in the living room to the west of the cottage.

You can see an old desk (on which is a piece of paper) here.

>write george on paper
You do not have anything to write with.

>x feather
Upon closer inspection you realise that the shaft is hollow and the end is sharpened to a point. The feather is in fact a quill pen.

>write george on paper
As you finish writing, you hear a "click" from upstairs, as if a door was being unlocked.

>e
The Lobby
You are in the lobby. The room is large and mostly empty, save for a few shelves. A kitchen is to the north, while to the west is a large living room.

On one of the shelves you see an old clock.

You can see George here.

>u
The Upstairs Hallway
You climb the creaky staircase and emerge in a small hallway. There are no windows up here, but the dim light from downstairs reveals an ominous looking door to the north. Light also emanates from the edges of the door, as if the door leads directly out into the open air.

As the creaking of the floorboards subsides, you realise that you can hear a slow, deep breathing. It appears to be coming from the other side of the door to the north.

>x door
A dusty timber door. Someone has etched the outline of a cat into the centre. Light emanates from the edges of the door. The gap at the bottom of the door looks wide enough to see under.

>s
You can't go that way.

>n
(first opening the Ominous Door)

The Bedroom
You hold your breath as you enter the room, and you find yourself alone. You infer from the furniture that this room had once served as the cottage's bed chamber. The room is as sparse and dusty as the rest of the cottage, a ramshackle bed frame is situated against the east wall next to an old dressing table, on which is a dusty mirror. Light pours through a large window on the far wall.

Whoever had occupied this room has clearly vacated - only a set of dusty footprints indicate that anyone was ever here.

>clean mirror
You wipe away the dust from the mirror.

* * *

>x mirror
As you stare into the glass of the mirror, you realise to your horror that visage staring back at you is that of a scarecrow. You jolt backwards only to see the scarecrow jolt identically. You bring your right hand up to your face, and once again your reflection reciprocates. You contemplate in disbelief that you are a mere facsimile of a man, a thing of straw and cloth. You stumble backwards and use the bed frame to support yourself.

As you correct yourself, you notice something out of the window.

>s
The Upstairs Hallway
You are standing in the upstairs hallway of the cottage. The only exits are back downstairs and north towards a room at the front of the cottage.

As you stumble into the hallway, you feel an itch at the back of your soft sack-like head. Before you can react, a small door-mouse drops past your eyes and makes a small thud on the floor, before scurrying off downstairs.

>d
The Lobby
You are in the lobby. The room is large and mostly empty, save for a few shelves. A kitchen is to the north, while to the west is a large living room.

On one of the shelves you see an old clock.

Through the door to the north you can see the barley fields, and the distant outline of the strange figure against the post.

>n
Front Of The Cottage
You stand in front of a large two storey cottage . A field of barley lies to the North. A path leads around the side of the cottage to the southwest. The cottage itself is directly south, the entrance blocked by a heavy oak door.

The crows continue to circle and caw all around, landing on the various protrusions on and around the cottage. 

You can make out a wiry black figure resting against the post to the north.    

The sound of the crows is much louder now.

You can make out the figure to the north in more detail now. It is clearly humanoid in appearance, wiry and gaunt. You can't quite tell yet, but there is something not quite right about the figure's bulbous head.

>n
As you enter the barley field, you see that a wiry humanoid figure now stands in place of the scarecrow. The figure is covered in glossy black fur and long, sharp-looking fingernails. its over-sized head is that of a feline. The creature's emerald eyes stare straight at you as you move closer towards it, following you as you approach. The cat is smiling widely, revealing two yellowing fangs beneath his brownish lips. He begins to speak;
 "Well done, my fine fellow, well done" he says, jovially, "Haha, nothing contributes so much to tranquilize the mind as a steady purpose! It wasn't easy but we bloody well did it didn't we! The enemy was nought but a pounder after all!"
 The creature notices your confusion.
 "I know, nothing is so painful to the human mind as a great and sudden change, but don't you see lad, it's over!" he spins his head around in almost a complete circle, gesturing to the surrounding landscape "We won! You don't need to defend this land any more, you can return to your old life! Haha!"
 The creature furrows his brow as he notices that you still don't quite understand what he is implying.
 "Look" he continues "There is little point in you resuming your station here, boy, these fields are no longer in need of defence!"
 He is clearly losing his patience at your lack of response. His voice takes on a sudden stern-ness.
 "I desire what is good. Therefore, everyone who does not agree with me is a traitor. It is good that you have done this service for your kingdom, but your services are no longer required and therefore it is good that you should return to your old life. Unless, that is, you disagree with me?"
 And with that, you feel the life drain out of you, and the sack, coat, boots, hat and trousers fall to the floor in a crumpled heap, splashing down unceremoniously into a puddle, in a field, in Suffolk.

Please press SPACE to continue.

    *** The End ***

Would you like to RESTART, RESTORE a saved game, QUIT or UNDO the last command?

* * *

>ne
You follow the garden path around to the front of the cottage.

As you make your way around the front of the cottage, you survey the area to see if you can identify the cause of the banging. Just as you are about to resign to having imagined the sound, you observe to your horror that the field to the north is now empty. 

The scarecrow has left his post!

You can vaguely make out that something has been nailed to the post in place of the scarecrow, flapping gently in the breeze.

Please press SPACE to continue.

Front Of The Cottage
You stand in front of a large two storey cottage . A field of barley lies to the north. A path leads around the side of the cottage to the southwest. The cottage itself is directly south, the entrance blocked by a heavy oak door.

 

In the field to the north you can see something nailed to a post.    

You can see the cat here.

The cat begins scratching in the undergrowth.

>unlock door with key
You unlock the Front Door.

* * *

>u
The Upstairs Hallway
You climb the creaky staircase and emerge in a small hallway. There are no windows up here, but the dim light from downstairs reveals an ominous looking door to the north. Light also emanates from the edges of the door, as if the door leads directly out into the open air. You can just about see that something is etched onto the door.

As the creaking of the floorboards subsides, you realise that you can hear a slow, deep breathing. It appears to be coming from the other side of the door to the north.

>d
The Lobby
You are in the lobby. The room is large and mostly empty, save for a few shelves. A kitchen is to the south, while to the west is a large living room.

On one of the shelves you see an old clock.

An old rickety staircase leads upstairs.

You can see the cat here.

The cat heads west to the living room.

the cat arrives from the west.

>w
The Living room
The living room, as with the rest of the cottage, is very sparsely furnished and ridden with dust and cobwebs. As you enter, your eye is caught by a crow at the window. The crow lets out a blood curdling screech and flies out of view.

You can see an old desk (on which is a piece of paper) here.

the cat arrives from the east.

>x desk
The desk is long and coated in dust. Set into the rear of the desk is an inkwell.

On the old desk is a piece of paper.

The cat appears to be carrying a black feather in his mouth. He deposits the feather on the ground in front of you and stares up at you, seeking some kind of praise.

>get feather
Taken.

The cat heads east to the lobby.

* * *

>x feather
Upon closer inspection you realise that the shaft is hollow and the end is sharpened to a point. The feather is in fact a quill pen.

>write george on paper
As you finish writing, you hear a "click" from upstairs, as if a door were being unlocked.

* * *

>n
(first opening the Ominous Door)

The Bedroom
You hold your breath as you enter the room, and you find yourself alone.  The room is as sparse and dusty as the rest of the cottage, a ramshackle bed frame is situated against the east wall next to an old dressing table, on which is a dusty mirror. Light pours through a large window on the far wall. The only exit is south to the hallway.

Whoever had occupied this room has clearly vacated - only a set of dusty footprints indicate that anyone was ever here.

>wipe mirror
You wipe away the dust from the mirror.

>x mirror
*** Run-time problem P1: Tried to move the strapped figure (a backdrop) to The Bedroom, which is not a region.

As you stare into the glass of the mirror, you realise to your horror that visage staring back at you is that of a scarecrow. You jolt backwards only to see the scarecrow jolt identically. You bring your right hand up to your face, and once again your reflection reciprocates. You contemplate in disbelief that you are a mere facsimile of a man, a thing of straw and cloth. You stumble backwards and use the bed frame to support yourself.

As you correct yourself, you notice something out of the window.

>x figure
You can't see any such thing.

* * *

Front Of The Cottage
You stand in front of a large two storey cottage . A field of barley lies to the North. A path leads around the side of the cottage to the southwest. The cottage itself is directly south, the entrance blocked by a heavy oak door. 

In the field to the north you can see something nailed to a post.

>unlock door with key
You unlock the Front Door.

You hear the harsh "caw" of a crow.

>s
(first opening the Front Door)

The Lobby
As you enter the cottage through the heavy oak door, you disturb a number of crows who were sheltering inside. A violent fury of black feathers whip past your face as the crows exit the cottage to join their brothers in the fields. 

The lobby itself is bare and largely unfurnished, with wooden floorboards that continue south into a food preparation area, and west into a large living room. A few shelves adorn the wall and a table sits against the western wall. You feel nauseous and short of breath. Surfaces feel cold and damp to the touch.

On one of the shelves you see an old clock.

the cat arrives from the north.

>x clock
The time reads eleven minutes past three.

The cat heads west to the living room.

the cat arrives from the west.

>w
The Living room
The living room, as with the rest of the cottage, is very sparsely furnished and ridden with dust and cobwebs. As you enter, your eye is caught by a crow at the window. The crow lets out a blood curdling screech and flies out of view.

You can see an old desk (on which is a piece of paper) here.

>x paper
You lean over the desk to read the message:

He hides away during the maelstrom, emerging only when he knows the landscape to be free from hazard. He wanders the fields, surveying the aftermath to amuse his curiosity. He greets the soldier as a friend, even though the two are strangers. The people still people warm to him, though he claws at their humility only to stroke his wretched ego.

He offers meagre trifles, but he is not to be trusted. Damn him, he who is named _________________________. 

At the foot of the letter is a dotted line, indicating that a word is missing.

>write on paper
You should try writing something ON something...

>write george on paper
You do not have anything to write with.

the cat arrives from the east.

>x desk
The desk is long and coated in dust. Set into the rear of the desk is an inkwell. On to the desk is a note. The not appears to be stuck to the desk with some kind of adhesive.

On the old desk is a piece of paper.

The cat appears to be carrying a black feather in his mouth. He deposits the feather on the ground in front of you and stares up at you, seeking some kind of praise.

>x inkwell
You can't see any such thing.

>get feather
Taken.

* * *

>x feather
Upon closer inspection you realise that the shaft is hollow and the end is sharpened to a point. The feather is in fact a quill pen.

>e
The Lobby
You are in the lobby. The room is large and mostly empty, save for a few shelves. A kitchen is to the north, while to the west is a large living room.

On one of the shelves you see an old clock.

>w
The Living room
You are standing in the living room to the west of the cottage.

You can see the cat and an old desk (on which is a piece of paper) here.

>write george on paper
As you finish writing, you hear a "click" from upstairs.

The cat heads east to the lobby.

>e
The Lobby
You are in the lobby. The room is large and mostly empty, save for a few shelves. A kitchen is to the north, while to the west is a large living room.

On one of the shelves you see an old clock.

You can see the cat here.

The cat meows.

>u
The Upstairs Hallway
You climb the creaky staircase and emerge in a small hallway. There are no windows up here, but the dim light from downstairs reveals an ominous looking door to the north. Light also emanates from the edges of the door, as if the door leads directly out into the open air.

As the creaking of the floorboards subsides, you realise that you can hear a slow, deep breathing. It appears to be coming from the other side of the door to the north.

>n
(first opening the Ominous Door)

The Bedroom
You hold your breath as you enter the room, and you find yourself alone. You infer from the furniture that this room had once served as the cottage's bed chamber. The room is as sparse and dusty as the rest of the cottage, a ramshackle bed frame is situated against the east wall next to an old dressing table, on which is a dusty mirror. Light pours through a large window on the far wall.

Whoever had occupied this room has clearly vacated - only a set of dusty footprints indicate that anyone was here.

>x mirror
The mirror is mounted on a bronze frame. You can not make out your reflection as the mirror is too dusty.

>clean mirror
You achieve nothing by this.

>dust mirror
You achieve nothing by this.

* * *

>se
The fields of corn seem to go on forever and there would be little point in entering them. The Farm Path is north. Front Of The Cottage is south.

>s
Front Of The Cottage
You approach the front of a large two storey cottage that is very familiar to you. A field of barley lies to the north. A path leads around the side of the cottage to the southwest. The cottage itself is directly south, the entrance blocked by a heavy oak door.

The crows continue to circle and caw all around, landing on the various protrusions around the cottage. 

You feel suddenly very sad, as if there is something at work in your soul which you do not understand.   

The small black cat from the farm path is here, washing himself among the barley. 

You hear the harsh "caw" of a crow.

>se
You follow garden path to the back of the cottage.

Back of the Cottage
You arrive in an ample-sized clearing of trampled barley which serves as a yard for the cottage.

You feel a slight twinge in your knee and wince in pain as you correct yourself. In that instant your thoughts turn to musket fire and the mayhem of battle, and to the sharp and sudden trauma below your right femur. 

And to falling. And to the wet earth.

You take a moment to gather your composure. You close your eyes and begin repeating to yourself "You are home. You are alive. " Eventually you open your eyes and breathe in the cold country air.

On the perimeter of the clearing is an old, broken plough. You can also see an ancient gnarled tree here.

* * *

>ne
You follow the garden path around to the front of the cottage.

As you make your way around the front of the cottage, you survey the area to see if you can identify the cause of the banging. Just as you are about to resign to having imagined the sound, you observe to your horror that the field to the north is now empty. 

The scarecrow has left his post!

You can vaguely make out that something has been nailed to the post in place of the scarecrow, flapping gently in the breeze.

Please press SPACE to continue.

Front Of The Cottage
You stand in front of a large two storey cottage . A field of barley lies to the north. A path leads around the side of the cottage to the southwest. The cottage itself is directly south, the entrance blocked by a heavy oak door.

 

In the field to the north you can see something nailed to a post.   

The small black cat from the farm path is here, washing himself among the barley.

>stroke cat
You kneel down and hold your arm out towards the cat, who responds by rubbing his face against your hand and purring loudly. He seems more comfortable around you now.

* * *

>w
The Living room
The living room, as with the rest of the cottage, is very sparsely furnished and ridden with dust and cobwebs. As you enter, your eye is caught by a crow at the window. The crow lets out a blood curdling screech and flies out of view.

You can see an old desk (on which is a piece of paper) here.

>e
The Lobby
You are in the lobby. The room is large and mostly empty, save for a few shelves. A kitchen is to the south, while to the west is a large living room.

On one of the shelves you see an old clock.

An old rickety staircase leads upstairs.

>n
Front Of The Cottage
You stand in front of a large two storey cottage . A field of barley lies to the north. A path leads around the side of the cottage to the southwest. The cottage itself is directly south, the entrance blocked by a heavy oak door.

 

In the field to the north you can see something nailed to a post.    

You can see the cat here.

The cat yawns.

>s
The Lobby
You are in the lobby. The room is large and mostly empty, save for a few shelves. A kitchen is to the south, while to the west is a large living room.

On one of the shelves you see an old clock.

An old rickety staircase leads upstairs.

>u
The Upstairs Hallway
You climb the creaky staircase and emerge in a small hallway. There are no windows up here, but the dim light from downstairs reveals an ominous looking door to the north. Light also emanates from the edges of the door, as if the door leads directly out into the open air. You can just about see that something is etched onto the door.

As the creaking of the floorboards subsides, you realise that you can hear a slow, deep breathing. It appears to be coming from the other side of the door to the north.

>d
The Lobby
You are in the lobby. The room is large and mostly empty, save for a few shelves. A kitchen is to the south, while to the west is a large living room.

On one of the shelves you see an old clock.

An old rickety staircase leads upstairs.

>z
Time passes.

the cat arrives from the north.

>z
Time passes.

The cat heads south to the kitchen.

the cat arrives from the south.

>z
Time passes.

The cat appears to be carrying a black feather in his mouth. He deposits the feather on the ground in front of you and stares up at you, seeking some kind of praise.

* * *

>clean cat
Woop.

>knock cat
You are not sure that knocking on that will achieve anything.

The cat wags his tail violently from side to side.

* * *

>clean cat
Woop.

>wipe cat
You achieve nothing by this.

You hear the harsh "caw" of a crow.

>rub cat
You achieve nothing by this.

* * *

>clean cat
Woop.

>clean gate
You achieve nothing by this.

* * *

>rub cat
Woop.

* * *

>x fields
Acres of barley, wheat and oat stretch over the horizon. Your eyes hurt as you stare into the distance, and the landscape seems to throb giving you a sudden headache. The fields are wild and unkempt. Many of the crops have been ravaged by disease.

In amongst the crop here you see a folded piece of paper. It appears to be a letter.

The cat tilts his head to one side.

>get letter
Taken.

The cat wags his tail violently from side to side.

>s
(first opening the wooden gate)

The Barley Field
As you enter the barley field, your mind drifts to the fields of battle in the aftermath of Waterloo. The casualties were horrendous, the victory far from glorious. Many of the soldiers who died that day, the "scum of the earth" as Wellington had described them, had been recruited from villages and hamlets nearby. Wellington had later reflected that it was "really wonderful that we should have made these men into the fine fellows they are." You consider the barrenness of that statement  now that tens of thousands of those fine fellows are dead. Many of those who survived were not the same as they were before the war, having succumbed to war exhaustion or madness, or worse.

The stench of death is here, exemplified by the many dying and disease-ravaged crops left to abandonment in the surrounding fields. The chill wind is making it hard to breathe, and you begin to feel light headed. Further south through the fields you can see the old farm cottage. 

An old rotting wooden post is here. Propped up against the post, standing to attention, is a lone scarecrow.

>x undergrowth
Deep green foliage serves as a natural barrier separating the fields.

Something in the nearby undergrowth catches your eye - it appears to be a letter.

>get letter
(page two of a letter)
Taken.

>i
You are carrying:
  page two of a letter
  page one of a letter

>read page 1
You can't see any such thing.

>read page one
You start the letter:

   
General Hospital, Antwerp, 24th June 1815. After a long silence, I embrace the opportunity of informing you respecting my present situation. On the 15th, about 12 o'clock at night, we turned out and at two in the morning marched from the city of Brussels to meet the enemy, who were advancing in great force on that city. About three o'clock in the afternoon of the 16th, we came up with them. Our whole force did not exceed 12,000 men, who were fatigued with a long march of upwards of 20 miles and encumbered with knapsacks and other luggage. The day was uncommonly warm, and no water was to be had on the road; however, we were brought up in order of battle. The French being strongly posted in a thick wood, to the number of 40,000 men including cavalry and lancers, gave us very little time to look around us ere the fight commenced on both sides, in an awful and destructive manner, they having every advantage of us, both as to position and numbers, particularly in cavalry, as the British dragoons had not yet come up.

A scrawl at the bottom of the letter indicates that this is part 1 of 4.

* * *

>write fuck off on cat
You can't see any such thing.

>write hello on gate
You can't see any such thing.

>write gate on sky
the wooden gate.

* * *

>clean gate
You achieve nothing by this.

>clean cat
You achieve nothing by this.

You hear the harsh "caw" of a crow.

>knock cat
You are not sure that knocking on that will achieve anything.

* * *

In the winter of 1815, after countless millions had perished, the Napoleonic Wars came to an end. The little corporal Napoleon Bonaparte, emperor of France for the decade previous, was exiled to the volcanic island of St Helena where he would see out the last six years of his life.

The end of the Napoleonic wars saw the start of a great agricultural depression in the United Kingdom that would last for a quarter of a century. Many farms succumbed to abandonment and disrepair as both landlords and tenants fell into bankruptcy.

It is in the wake of this ruin, far from the bloody fields of Waterloo and Rocquencourt, that you find yourself standing on a long farm road in Suffolk, surrounded by fields of oat, barley and wheat. A dull lifelessness hangs in the air like mist. All is silent, save for the cries of carrion crow circling above. You feel your heart longing for the rural paradise now lost to time and neglect.

Five hundred miles away, a young author called Mary Shelley has finished writing her first novel, "The Modern Prometheus"...

Please press SPACE to continue.

The Scarecrow
An exploration of war and belonging by Mikey Hogarth The story genre is "Horror"
Release 1 / Serial number 130922 / Inform 7 build 6G60 (I6/v6.32 lib 6/12N) SD

The Farm Path
You are standing on a muddy farm path. A wooden gate to the south leads into a large barley field which forms part of a patchwork vista of yellow and brown draped over the distant landscape. The fields are separated by deep green foliage. 

Your journey here has been long and tiring. Beyond the field to the south you can see a thatched-roof cottage, a place you had once felt a connection with. A place you had once called home. In spite of your aching feet, the cottage no longer feels like an inviting respite. 

The weather is overcast and a gentle rain is falling, casting a damp film across the landscape.  

You see a small black cat sheltering under some nearby foliage.

>knock on gate
The cat meows.

* * *

In the winter of 1815, after countless millions had perished, the Napoleonic Wars came to an end. The little corporal Napoleon Bonaparte, emperor of France for the decade previous, was exiled to the volcanic island of St Helena where he would see out the last six years of his life.

The end of the Napoleonic wars saw the start of a great agricultural depression in the United Kingdom that would last for a quarter of a century. Many farms succumbed to abandonment and disrepair as both landlords and tenants fell into bankruptcy.

It is in the wake of this ruin, far from the bloody fields of Waterloo and Rocquencourt, that you find yourself standing on a long farm road in Suffolk, surrounded by fields of oat, barley and wheat. A dull lifelessness hangs in the air like the fog of war. All is silent, save for the cries of carrion crow circling above. You feel your heart longing for the rural paradise now lost to time and neglect.

Five hundred miles away, a young author called Mary Shelley has finished writing her first novel, "The Modern Prometheus"...

Please press SPACE to continue.

The Scarecrow
An exploration of war and belonging by Mikey Hogarth The story genre is "Horror"
Release 1 / Serial number 130926 / Inform 7 build 6G60 (I6/v6.32 lib 6/12N) SD

The Farm Path
You are standing on a muddy farm path. A wooden gate to the south leads into a large barley field which forms part of a patchwork vista of yellow and brown draped over the distant landscape. The fields are separated by deep green foliage. 

Your journey here has been long and tiring. Beyond the field to the south you can see a thatched-roof cottage, a place you had once felt a connection with. A place you had once called home. In spite of your aching feet, the cottage no longer feels like an inviting respite. 

The weather is overcast and a gentle rain is falling, casting a damp film across the landscape.  

You see a small black cat sheltering under some nearby foliage.

>x cat
The cat stares at you with wide yellow eyes which convey both curiosity and caution in equal measures.

As you watch the cat, you suddenly become aware of a letter on the ground next to him, previously obscured.

The cat meows.

>x letter
You start the letter:

General Hospital, Antwerp, 24th June 1815. After a long silence, I embrace the opportunity of informing you respecting my present situation. On the 15th, about 12 o'clock at night, we turned out and at two in the morning marched from the city of Brussels, to meet the enemy, who were advancing in great force on that city. About three o'clock in the afternoon of the 16th, we came up with them. Our whole force did not exceed 12,000 men, who were fatigued with a long march of upwards of 20 miles, encumbered with knapsacks and other luggage. The day was uncommonly warm, and no water to be had on the road; however, we were brought up, in order of battle. The French being strongly posted in a thick wood, to the number of 40,000 men, including cavalry and lancers, gave us very little time to look around us ere the fight commenced on both sides, in an awful and destructive manner, they having every advantage of us, both as to position and numbers, particularly in cavalry, as the British dragoons had not yet come up.

A scrawl at the bottom of the letter indicates that this is part 1 of 4.

* * *

The Scarecrow
An exploration of war and belonging by Mikey Hogarth The story genre is "Horror"
Release 1 / Serial number 130925 / Inform 7 build 6G60 (I6/v6.32 lib 6/12N) SD

The Farm Path
You are standing on a muddy farm path. A wooden gate to the south leads into a large barley field which forms part of a patchwork vista of yellow and brown draped over the distant landscape. The fields are separated by deep green foliage. 

Your journey here has been long and tiring. Beyond the field to the south you can see a thatched-roof cottage, a place you had once felt a connection with. A place you had once called home. In spite of your aching feet, the cottage no longer feels like an inviting respite. 

The weather is overcast and a gentle rain is falling, casting a damp film across the landscape.  

You see a small black cat sheltering under some nearby foliage.

>s
(first opening the wooden gate)

The Barley Field
As you enter the barley field, your mind drifts to the fields of battle in the aftermath of Waterloo. The casualties were horrendous, the victory far from glorious. Many of the soldiers who died that day, the "scum of the earth" as Wellington had described them, had been recruited from villages and hamlets nearby. Wellington had later claimed  that it was "really wonderful that we should have made these men into the fine fellows they are." You consider the barrenness of that statement  now that tens of thousands of those fine fellows are dead. Many of those who survived were not the same as they were before the war, having succumbed to war exhaustion or madness, or worse.

The chill wind is making it hard to breathe, and you begin to feel light headed. Further south through the fields you can see the old farm cottage. 

An old rotting wooden post is here. Propped up against the post, standing to attention, is a lone scarecrow.

* * *

>get key
As you pick up the key, your heart jolts - you hear four loud bangs coming from the front of the cottage, like metal knocking on wood. The sound echoes around the hills and then all is silent again.

>ne
You follow the garden path around to the front of the cottage.

OMG NO SCARECROW!

Please press SPACE to continue.

Front Of The Cottage
You stand in front of a large two storey cottage . A field of barley lies to the North. A path leads around the side of the cottage to the southwest. The cottage itself is directly south, the entrance blocked by a heavy oak door. 

In the field to the north you can see something nailed to a post.

* * *

Everything is supposed to be very quiet after a massacre, and it always is, except for the birds. And what do the birds say? All there is to say about a massacre, things like "Poo-tee-weet". -- Kurt Vonnegut

Please press SPACE to continue.

In the winter of 1815, after countless millions had perished, the Napoleonic Wars came to an end. The little corporal Napoleon Bonaparte, emperor of France for the decade previous, was exiled to the volcanic island of St Helena where he would see out the last six years of his life.

The end of the Napoleonic wars saw the start of a great agricultural depression in the United Kingdom that would last for a quarter of a century. Many farms succumbed to abandonment and disrepair as both landlords and tenants fell into bankruptcy.

It is in the wake of this ruin, far from the bloody fields of Waterloo and Rocquencourt, that you find yourself standing on a long farm road in Suffolk, surrounded by patchwork fields of oat, barley and wheat. A dull lifelessness hangs in the air like the fog of war. All is silent, save for the cries of carrion crow circling above.

Five hundred miles away, a young author called Mary Shelley has finished writing her first novel, "The Modern Prometheus"...

Please press SPACE to continue.

>x cat
The cat stares at you with wide yellow eyes which convey both curiosity and caution in equal measures.

As you watch the cat, you suddenly become aware of a letter on the ground next to him, previously obscured.

You hear the harsh "caw" of a crow.

* * *

>s
(first opening the wooden gate)

The Barley Field
As you enter the barley field, your mind drifts to the fields of battle in the aftermath of Waterloo. The casualties were horrendous, the victory far from glorious. Many of the soldiers who died that day, the "scum of the earth" as Wellington had described them, had been recruited from villages and hamlets nearby. Wellington had later claimed  that it was "really wonderful that we should have made these men into the fine fellows they are." You consider the barrenness of that statement  now that tens of thousands of those fine fellows are dead. Many of those who survived were not the same as they were before the war, having succumbed to war exhaustion or madness, or worse.

The chill wind is making it hard to breathe, and you begin to feel light headed. Further south through the fields you can see the old farm cottage. 

An old rotting wooden post is here. Propped up against the post, standing to attention, is a lone scarecrow.

>s
Front Of The Cottage
You approach the front of a large two storey cottage that is very familiar to you. A field of barley lies to the North. A path leads around the side of the cottage to the southwest. The cottage itself is directly south, the entrance blocked by a heavy oak door.

>se
You follow garden path to the back of the cottage.

Back of the Cottage
You arrive in an ample-sized clearing of trampled barley which serves as a yard for the cottage.

You feel a slight twinge in your knee and wince in pain as you correct yourself. Your thoughts turn to musket fire and the mayhem of battle, to sharp and sudden trauma below your right femur. You take a moment to gather your composure and you tell yourself "You are home. You are alive.".

On the perimeter of the clearing is an old, broken plough.

* * *

The weather is overcast and a gentle rain is falling. The wind here is chill, and the crows are legion.

The Scarecrow
A short Napoleonic agricultural chiller by Mikey Hogarth The story genre is "Horror"
Release 1 / Serial number 130929 / Inform 7 build 6G60 (I6/v6.32 lib 6/12N) SD

The Farm Path
You are standing on a muddy farm path. A wooden gate to the south leads into a large barley field. Similar fields lead off into the distance, separated from one another by deep green foliage. 

Your journey here has been long and tiring. Beyond the field to the south you can see a thatched-roof cottage, a place you had once called home. In spite of your aching feet, the cottage no longer feels like an inviting respite .  

You see a small black cat sheltering under some nearby foliage.

* * *

Everything is supposed to be very quiet after a massacre, and it always is, except for the birds. And what do the birds say? All there is to say about a massacre, things like "Poo-tee-weet". -- Kurt Vonnegut

Please press SPACE to continue.

>s
(first opening the wooden gate)

The Barley Field
As you enter the barley field, your mind drifts to the fields of battle in the aftermath of Waterloo. The casualties were horrendous, the victory far from glorious. Many of the soldiers who died that day, the "scum of the earth" as Wellington had described them, had been recruited from villages and hamlets nearby. Wellington had later claimed  that it was "really wonderful that we should have made these men into the fine fellows they are." You consider the barrenness of that statement  now that tens of thousands of those fine fellows were dead. Many of those who survived were not the same as they were before the war, having succumbed to war exhaustion or madness, or worse.

The chill wind is making it hard to breathe, and you begin to feel light headed. Further south through the fields you can see the old farm cottage. 

An old rotting wooden post is here. Propped up against the post, standing to attention, is a lone scarecrow.

>e
The fields of corn seem to go on forever and there would be little point in entering them.
Exits are The Farm Path is north. Front Of The Cottage is south. .

* * *

Everything is supposed to be very quiet after a massacre, and it always is, except for the birds. And what do the birds say? All there is to say about a massacre, things like "Poo-tee-weet". -- Kurt Vonnegut

Please press SPACE to continue.

>x cat
The cat stares at you with wide yellow eyes which convey both curiosity and caution in equal measures.

As you watch the cat, you suddenly become aware of a letter on the ground next to him, previously obscured.

>get page
Taken.

>l
The Farm Path
A wooden gate to the south leads to a field of barley. 

You see a small black cat sheltering under some nearby foliage.

The cat meows.

* * *

>n
The Farm Path
A wooden gate to the south leads to a field of barley. 

You see a small black cat sheltering under some nearby foliage.

You hear the harsh "caw" of a crow.

>stroke cat
As you approach the cat, it flees into the undergrowth.

* * *

>s
The Barley Field
You are standing in a field of barley. To the north is a wooden gate leading to a farm path. A cottage lies to the south.

An old rotting wooden post is here. Propped up against the post, standing to attention, is a lone scarecrow.

>s
Front Of The Cottage
You approach the front of a large two storey cottage that is very familiar to you. A field of barley lies to the North. A path leads around the side of the cottage to the southwest. The cottage itself is directly south, the entrance blocked by a heavy oak door.  

The small black cat from the farm path is here, washing himself among the barley.

>z
Time passes.

You feel a cool breeze.

>z
Time passes.

The cat tilts his head to one side.

>z
Time passes.

The cat wags his tail violently from side to side.

>z
Time passes.

>stroke cat
You kneel down and hold your arm out towards the cat, who responds by rubbing his face against your hand and purring loudly. He seems more comfortable around you now.

The cat begins scratching in the undergrowth.

>z
Time passes.

* * *

>z
Time passes.

You hear the harsh "caw" of a crow.

>z
Time passes.

The cat heads north to the barley field.

>follow cat
(heading north)

The Barley Field
You are standing in a field of barley. To the north is a wooden gate leading to a farm path. A cottage lies to the south.

An old rotting wooden post is here. Propped up against the post, standing to attention, is a lone scarecrow.

You can also see the cat here.

* * *

The weather is overcast and a gentle rain is falling. The wind here is chill, and the crows are legion.

The Scarecrow
A short Napoleonic agricultural chiller by Mikey Hogarth The story genre is "Horror"
Release 1 / Serial number 130928 / Inform 7 build 6G60 (I6/v6.32 lib 6/12N) SD

The Farm Path
You are standing on a muddy farm path. A wooden gate to the south leads into a large barley field. Similar fields lead off into the distance, separated from one another by deep green foliage. 

Your journey here has been long and tiring. Beyond the field to the south you can see a thatched-roof cottage, a place you had once called home. In spite of your aching feet, the cottage no longer feels like an inviting respite .  

You see a small black cat sheltering under some nearby foliage.

* * *

>s
(first opening the wooden gate)

The Barley Field
As you enter the barley field, your mind drifts to the fields of battle in the aftermath of Waterloo. The casualties were horrendous, the victory far from glorious. Many of the soldiers who died that day, the "scum of the earth" as Wellington had described them, had been recruited from villages and hamlets nearby. Wellington had later claimed  that it was "really wonderful that we should have made these men into the fine fellows they are." You consider the barrenness of that statement  now that tens of thousands of those fine fellows were dead. Many of those who survived were not the same as they were before the war, having succumbed to war exhaustion or madness, or worse.

The chill wind is making it hard to breathe, and you begin to feel light headed. Further south through the fields you can see the old farm cottage. 

An old rotting wooden post is here. Propped up against the post, standing to attention, is a lone scarecrow.

* * *

>enter corn
The fields of corn seem to go on forever and there would be little point in entering them. The Barley Field is south. 
You hear the harsh "caw" of a crow.

The cat meows.

* * *

>e
The fields of corn seem to go on forever and there would be little point in entering them. The Farm Path is north. Front Of The Cottage is south.

>s
Front Of The Cottage
You approach the front of a large two storey cottage that is very familiar to you. A field of barley lies to the North. A path leads around the side of the cottage to the southwest. The cottage itself is directly south, the entrance blocked by a heavy oak door.

>n
The Barley Field
You are standing in a field of barley. To the north is a wooden gate leading to a farm path. A cottage lies to the south.

An old rotting wooden post is here. Propped up against the post, standing to attention, is a lone scarecrow.

* * *

>n
The Farm Path
A wooden gate to the south leads to a field of barley. 

You see a small black cat sheltering under some nearby foliage.

>s
The Barley Field
You are standing in a field of barley. To the north is a wooden gate leading to a farm path. A cottage lies to the south.

An old rotting wooden post is here. Propped up against the post, standing to attention, is a lone scarecrow.

I beg your pardon?

>s
Front Of The Cottage
You stand in front of a large two storey cottage . A field of barley lies to the North. A path leads around the side of the cottage to the southwest. The cottage itself is directly south, the entrance blocked by a heavy oak door.

* * *

>enter corn
The fields of corn seem to go on forever and there would be little point in entering them. The Barley Field is south.

>s
(first opening the wooden gate)

The Barley Field
As you enter the barley field, your mind drifts to the fields of battle in the aftermath of Waterloo. The casualties were horrendous, the victory far from glorious. Many of the soldiers who died that day, the "scum of the earth" as Wellington had described them, had been recruited from villages and hamlets nearby. Wellington had later claimed  that it was "really wonderful that we should have made these men into the fine fellows they are." You consider the barrenness of that statement  now that tens of thousands of those fine fellows were dead. Many of those who survived were not the same as they were before the war, having succumbed to war exhaustion or madness, or worse.

The chill wind is making it hard to breathe, and you begin to feel light headed. Further south through the fields you can see the old farm cottage. 

An old rotting wooden post is here. Propped up against the post, standing to attention, is a lone scarecrow.

* * *

>x cat
The cat stares at you with wide yellow eyes which convey both curiosity and caution in equal measures.

The cat meows.

>l
The Farm Path
A wooden gate to the south leads to a field of barley. 

You see a small black cat sheltering under some nearby foliage.

You can see a page one of a letter here.

* * *

>x cat
The cat stares at you with wide yellow eyes which convey both curiosity and caution in equal measures.

The cat meows.

>x undergrowtn
Deep green foliage serves as a natural barrier separating the fields.

Something in the nearby undergrowth catches your eye - it appears to be a letter.

>l
The Farm Path
A wooden gate to the south leads to a field of barley. 

You see a small black cat sheltering under some nearby foliage.

You can see page one of a letter here.

You hear the harsh "caw" of a crow.

The cat begins scratching in the undergrowth.

>s
(first opening the wooden gate)

The Barley Field
As you enter the barley field, your mind drifts to the fields of battle in the aftermath of Waterloo. The casualties were horrendous, the victory far from glorious. Many of the soldiers who died that day, the "scum of the earth" as Wellington had described them, had been recruited from villages and hamlets nearby. Wellington had later claimed  that it was "really wonderful that we should have made these men into the fine fellows they are." You consider the barrenness of that statement  now that tens of thousands of those fine fellows are dead. Many of those who survived were not the same as they were before the war, having succumbed to war exhaustion or madness, or worse.

The chill wind is making it hard to breathe, and you begin to feel light headed. Further south through the fields you can see the old farm cottage. 

An old rotting wooden post is here. Propped up against the post, standing to attention, is a lone scarecrow.

* * *

>x boots
A muddy black pair of wellingtons.

>x coat
A tattered red coat.

As you run your fingers along the hem of one of the sleeves, a folded piece of paper falls from one of the inside pockets. It appears to be a letter.

* * *

>l
The Barley Field
You are standing in a field of barley. To the north is a wooden gate leading to a farm path. A cottage lies to the south.

An old rotting wooden post is here. Propped up against the post, standing to attention, is a lone scarecrow.

You can also see page two of a letter here.

>se
The fields of corn seem to go on forever and there would be little point in entering them. The Farm Path is north. Front Of The Cottage is south.

* * *

>s
Front Of The Cottage
You approach the front of a large two storey cottage that is very familiar to you. A field of barley lies to the North. A path leads around the side of the cottage to the southwest. The cottage itself is directly south, the entrance blocked by a heavy oak door.

>se
You follow garden path to the back of the cottage.

Back of the Cottage
You arrive in an ample-sized clearing of trampled barley which serves as a yard for the cottage. The fields continue off into the distance in all directions.  

On the perimeter of the clearing is an old, broken turnwrest plough.

* * *

>x plough
In addition to the rust and general disrepair of the plough, the cumbersome plough also appears to have been damaged - the blades and handles are bent at awkward angles rendering the plough useless.

Hanging from the plough, you see a rusty key.

>ne
You follow the garden path around to the front of the cottage.

Front Of The Cottage
You stand in front of a large two storey cottage . A field of barley lies to the North. A path leads around the side of the cottage to the southwest. The cottage itself is directly south, the entrance blocked by a heavy oak door.

>se
You follow garden path to the back of the cottage.

Back of the Cottage
You are standing at the rear of the cottage.

On the perimeter of the clearing is an old, broken turnwrest plough.

On the plough is a rusty key.

>get key
As you pick up the key, your heart jolts - you hear four loud bangs coming from the front of the cottage, like metal knocking on wood. The sound echoes around the hills and then all is silent again.

>se
The fields of corn seem to go on forever and there would be little point in entering them. Front Of The Cottage is northwest.

>ne
You follow the garden path around to the front of the cottage.

As you make your way around the front of the cottage, you survey the area to see if you can identify the cause of the banging. Just as you are about to resign to having imagined the sound, you observe to your horror that the field to the north is now empty. The scarecrow has left his post! You can vaguely make out that something has been nailed to the post in place of the scarecrow, flapping gently in the breeze.

Please press SPACE to continue.

Front Of The Cottage
You stand in front of a large two storey cottage . A field of barley lies to the North. A path leads around the side of the cottage to the southwest. The cottage itself is directly south, the entrance blocked by a heavy oak door. 

In the field to the north you can see something nailed to a post.  

You feel a cool breeze.

>n
The Barley Field
You are standing in a field of barley. To the north is a wooden gate leading to a farm path. A cottage lies to the south.

An old rotting wooden post is here. 

On the post is a note.

You can also see page two of a letter here.

>x note
There is a message inscribed onto the note in what looks like charcoal. The author has used aggressive straight lines to etch out each letter. The message reads:

"Your place is in the fields"

You hear the harsh "caw" of a crow.

* * *

Welcome to "The Scarecrow". If you have not experienced interactive fiction before, type "Help" at the prompt to get you started.

Please press SPACE to continue.

>stroke cat
As you approach the cat, it flees into the undergrowth.

>s
(first opening the wooden gate)

The Barley Field
As you survey this rural wasteland, your mind drifts to the fields of battle in the aftermath of Waterloo. The casualties were horrendous, the victory far from glorious. Many of the soldiers who died that day, the "scum of the earth" as Wellington had described them, had been recruited from villages and hamlets nearby. Wellington had later reflected that it was "really wonderful that we should have made these men into the fine fellows they are." You consider the barrenness of that statement now that tens of thousands of those fine fellows are dead. Many of those who survived were not the same as they were before the war, having succumbed to war exhaustion, madness, or worse.

The stench of death is here, exemplified by the disease-ravaged crops left to abandonment in the surrounding fields. The chill wind makes it hard to breathe, and you begin to feel light headed. Further south through the fields you can see the old farm cottage. 

An old rotting wooden post is here. Propped up against the post, standing to attention, is a lone scarecrow.

>s
Front Of The Cottage
You approach the front of a large two storey cottage that is very familiar to you. A field of barley lies to the north. A path leads around the side of the cottage to the southwest. The cottage itself is directly south, the entrance blocked by a heavy oak door.

The crows continue to circle and caw all around, landing on the various protrusions around the cottage. 

You feel suddenly very sad, as if there is something at work in your soul which you do not understand.   

The small black cat from the farm path is here, washing himself among the barley.

>stroke cat
You kneel down and hold your arm out towards the cat, who responds by rubbing his face against your hand and purring loudly. He seems more comfortable around you now.

You hear the harsh "caw" of a crow.

>se
You follow garden path to the back of the cottage.

Back of the Cottage
You arrive in an ample-sized clearing of trampled barley which serves as a yard for the cottage.

You feel a slight twinge in your knee and wince in pain as you correct yourself. In that instant your thoughts turn to musket fire and the mayhem of battle, and to the sharp and sudden trauma below your right femur. 

And to falling. And to the wet earth.

You take a moment to gather your composure. You close your eyes and begin repeating to yourself "You are home. You are alive. " Eventually you open your eyes and breathe in the cold country air.

On the perimeter of the clearing is an old, broken plough. You can also see an ancient gnarled tree here.

* * *

>get key
As you pick up the key, your heart jolts - you hear four loud bangs coming from the front of the cottage, like metal knocking on wood. The sound echoes around the hills and then all is silent again.

>ne
You follow the garden path around to the front of the cottage.

As you make your way around the front of the cottage, you survey the area to see if you can identify the cause of the banging. Just as you are about to resign to having imagined the sound, you observe to your horror that the field to the north is now empty. 

The scarecrow has left his post!

You can vaguely make out that something has been nailed to the post in place of the scarecrow, flapping gently in the breeze.
Front Of The Cottage
You stand in front of a large two storey cottage . A field of barley lies to the north. A path leads around the side of the cottage to the southwest. The cottage itself is directly south, the entrance blocked by a heavy oak door.

 

In the field to the north you can see something nailed to a post.    

You can see the cat here.

>unlock door with key
You unlock the Front Door.

* * *

>u
The Upstairs Hallway
You climb the creaky staircase and emerge in a small hallway. There are no windows up here, but the dim light from downstairs reveals an ominous looking door to the north. Light also emanates from the edges of the door, as if the door leads directly out into the open air. You can just about see that something is etched onto the door.

As the creaking of the floorboards subsides, you realise that you can hear a slow, deep breathing. It appears to be coming from the other side of the door to the north.

>d
The Lobby
You are in the lobby. The room is large and mostly empty, save for a few shelves. A kitchen is to the south, while to the west is a large living room.

On one of the shelves you see an old clock.

An old rickety staircase leads upstairs.

the cat arrives from the north.

>w
The Living room
The living room, as with the rest of the cottage, is very sparsely furnished and ridden with dust and cobwebs. As you enter, your eye is caught by a crow at the window. The crow lets out a blood curdling screech and flies out of view.

You can see an old desk (on which is a piece of paper) here.

the cat arrives from the east.

>z
Time passes.

The cat appears to be carrying a black feather in his mouth. He deposits the feather on the ground in front of you and stares up at you, seeking some kind of praise.

>get feather
Taken.

The cat sits in silence, staring at you.

>x feather
Upon closer inspection you realise that the shaft is hollow and the end is sharpened to a point. The feather is in fact a quill pen.

The cat heads east to the lobby.

* * *

>u
The Upstairs Hallway
You are standing in the upstairs hallway of the cottage. The only exits are back downstairs and north towards a room at the front of the cottage.

>d
The Lobby
You are in the lobby. The room is large and mostly empty, save for a few shelves. A kitchen is to the south, while to the west is a large living room.

On one of the shelves you see an old clock.

An old rickety staircase leads upstairs.

You can see the cat here.

>climb stairs
The Upstairs Hallway
You are standing in the upstairs hallway of the cottage. The only exits are back downstairs and north towards a room at the front of the cottage.

>s
You can't go that way.

>n
(first opening the Ominous Door)

The Bedroom
You hold your breath as you enter the room, and you find yourself alone.  The room is as sparse and dusty as the rest of the cottage, a ramshackle bed frame is situated against the east wall next to an old dressing table, on which is a dusty mirror. Light pours through a large window on the far wall. The only exit is south to the hallway.

Whoever had occupied this room has clearly vacated - only a set of dusty footprints indicate that anyone was ever here.

>dust mirror
You wipe away the dust from the mirror.

>x mirror
As you stare into the glass of the mirror, you realise to your horror that visage staring back at you is that of a scarecrow. You jolt backwards only to see the scarecrow jolt identically. You bring your right hand up to your face, and once again your reflection reciprocates. You contemplate in disbelief that you are a mere facsimile of a man, a thing of straw and cloth. You stumble backwards and use the bed frame to support yourself.

As you correct yourself, you notice something out of the window.

>x window
Through the window, you can see the pole where the scarecrow once stood. In his place, you can see a strange silhouette-like figure propped against the post. It is difficult to tell from this distance, but you think that the figure is staring at you. You feel a compulsion to go back downstairs and take a closer look.

>s
The Upstairs Hallway
You are standing in the upstairs hallway of the cottage. The only exits are back downstairs and north towards a room at the front of the cottage.

As you stumble into the hallway, you feel an itch at the back of your soft sack-like head. Before you can react, a small dormouse drops past your eyes and makes a small thud on the floor, before scurrying off downstairs.

>n
The Bedroom
The bedroom is as sparse and dusty as the rest of the cottage, a ramshackle bed frame is situated against the east wall next to an old dressing table, on which is a dusty mirror. Light pours through a large window on the far wall. The only exit is south to the hallway.

>s
The Upstairs Hallway
You are standing in the upstairs hallway of the cottage. The only exits are back downstairs and north towards a room at the front of the cottage.

>d
The Lobby
You are in the lobby. The room is large and mostly empty, save for a few shelves. A kitchen is to the south, while to the west is a large living room.

On one of the shelves you see an old clock.

An old rickety staircase leads upstairs.

Through the door to the north you can see the barley fields, and the distant outline of the strange figure against the post.

>u
The Upstairs Hallway
You are standing in the upstairs hallway of the cottage. The only exits are back downstairs and north towards a room at the front of the cottage.

>go downstairs
The Lobby
You are in the lobby. The room is large and mostly empty, save for a few shelves. A kitchen is to the south, while to the west is a large living room.

On one of the shelves you see an old clock.

An old rickety staircase leads upstairs.

Through the door to the north you can see the barley fields, and the distant outline of the strange figure against the post.

>up
The Upstairs Hallway
You are standing in the upstairs hallway of the cottage. The only exits are back downstairs and north towards a room at the front of the cottage.